黄山 很 好 就是 管理 黄山 的 太差 坐 大巴 到 南大门 买票 要 排队 不想 排长队 得加 钱 坐 大巴 得 排队 去 云谷 人 特多 到 云谷 坐 缆车 还 得 排长队 七点 从 汤口 酒店 走 坐 上云谷 缆车 都 中午 点多 上山 人 特多 都 是 走 一步 挤 一步 人 挨着 人到 了 晚上 七点 才 坐 上 玉屏 索道 下山 下山 之后 还 得	__label__1
黄山 风景 很 美 可是 售票员 的 态度 大巴 司机 的 态度 有待 改善 天天 看着 这么 美的 风景 为什么 脾气 还是 这么 躁	__label__2
从前 两座 山日山 和 月 山 山上 两座 亭 日亭 和 月 亭	__label__1
买 了 票 没法 去 最差 的 携程 体验	__label__1
不能	__label__2
根本 没去 就 给 我 把 票 确认 了 美团 的 投诉 电话 全 电脑 问答 玩 我们 消费者 呢 马上 卸载 都 是 骗子 骗子 骗子	__label__1
为什么 不能 打 负分 这种 地方 也 收块 门票 我 真是 瞎了眼 了 才 去 这个 景点 水 全都 干 了 湖 都 见 河床 了 更 别说 上面 流下来 的 山泉 脏兮兮 的 一点 残水 里面 全是 树叶 和 饮料瓶 根本 就 没有 管理人员 维护 开 了 一个半 小时 车 十点 半到 的 景区 门口 包括 检票 、 进去 整个 景区 逛 完 出来 、 拍照 一 共用 时 半小时 出来 一看 时间 十一点 整太 可笑 了 又 开 一个半 小时 车 回家 谁 去 谁 后悔 以活 了 三十多年 的 人格担保 从来 没见 过 这么 烂 的 景点	__label__1
真 怀疑 鼓浪屿 怎么 出名 的 就是 一个 公园 不 知道 是 厦门人 素质 问题 还是 怎样 在 沙滩 碰到 一个 要钱 的 之前 一直 说 好话 但是 我们 没 给 因为 毕竟 他 有 生活 能力 的 他 竟然 说 我们 小气 我 就 呵呵 了 在 岛上 吃饭 也 是 反正 态度 就是 有 问题 东西 也 贵 我 也 没见 着 什么 文艺 气息 这么 多 没 深圳 的 免费 公园 好看 呵呵 了	__label__1
王府井大街 去过 个人感觉 那里 吃 的 东西 比 济南 的 芙蓉 街 味道 差 很 远 大家 有 机会 可以 去 济南 的 芙蓉 街 感受一下	__label__2
不 知道 干什么 的 无聊 透顶 的 岛屿 吃饭 加 人妖	__label__1
实际上 这个 景区 是 分为 两 部分 由 两个 村 管理 的 前半段 有人 维护 虽然 景色 一般 但是 环境 打理 的 还行 除了 景区 内 公厕 而 后半段 包含 了 两个 大 瀑布 的 部分 却是 从 年 山体 滑坡 以来 就 废弃 没 人 管理 了 重点 来 了 废弃 的 一半 并 没有 封闭 你 可以 从 收费 的 这边 一直 走 到 废弃 的 一头 出去 而 那 一段 基本 都 是 傍 着 山崖 升出 的 铁 楼梯 脚下 就是 深潭 而 景区 连 个 警示牌 都 没有 任 人 进入 后半段 年 开始 就 没人 维护 的 铁梯 栈道 要 一直 走 到 尽头 的 出口 才能 知道 这 半边 已经 封闭 了 现在 回想 都 觉得 后怕	__label__2
还 比不上 桂林 的 罗湖 山水 上 乐园 没什么 的 里面 的 设施 一般 水上 乐园 都 有 很 失望 几百元 的 门票 啊	__label__1
很 简单 的 一个 人造 洞穴 不 值得 一去 门票 还 不 便宜	__label__2
相对来说 性价比 不高 一般般 而已	__label__2
门票 特别 贵 门口 就 能 看见 大佛 了 没意思 不 值得 去 吃货 肯定 是 要 省 下 门票 钱 去 吃 好吃 的	__label__2
北京植物园 坐落于 京西 香 山脚下 于 年 竣工 距 市中心 公里 是 国家级 旅游 景区 、 全国 林业 科普 基地 、 全国 野生植物 保护 科普 教育 基地 、 全国 青少年 科技 教育 基地 、 中央 国家机关 思想 教育 基地 、 北京市 科普 教育 基地 、 北京市 首批 精品 公园 北京植物园 隶属于 北京市 公园 管理中心 内有 观赏植物 区 、 树木园 和 温室 区 等等 有 多条 公交 可 达	__label__2
崇文区 附近 风景 还 行 庙会 挺 出名	__label__2
四明山 森林公园 度假村 设施 很差 我们 小孩 半夜 二点 床上 被 蜈蚣 咬伤 打电话 到 前台 服务中心 被告 之 让 我们 自行 下山 去 医院 酒店 里 没有 任何 急救 措施 连 酒精 也 没有 我们 自行 网上 查 急救 措施 还好 咬行 不 厉害 一早 再 与 酒店 交涉 并 就医 森林公园 内 无 景点 门票 收费 元 一张 不合理 设施 服务 差差评	__label__1
秦时 明月 汉时关 恐怕 要 找寻 盛唐 旧梦 只有 去 月色 里 寻 了 大唐 芙蓉 园 君不见 大唐 遗风 没有 芙蓉 面 牡丹花 只有 喧闹 的 人流 令人 怅然	__label__2
我 是 号 左右 到 阆中 的 那 时候 刚好 去 了 成都 女朋友 一直 都 很 想 去 阆中 因为 宣传片 里面 的 阆中 古城 实在 是 太美太美 烟雨 朦胧 中 的 古城 、 南津关 美 不 可言 当时 确实 有点 失望 先说 一下 交通 我们 从 火车站 出来 刚刚 通车 公交车 不算 完善 不过 可以 坐 、 路到 一桥 古城 站 下车 我 当时 坐 过头 了 、 带 女朋友 走 了 两站 路 我 去 的 时候 刚好 不是 周末 人 很少 真的 很少 我们 在 天住 了 一 晚上 当时 去 到 太晚 了 只能 住 酒店 这个 有点 小 遗憾 晚上 九点 多 和 女朋友 想 去 看看 古城 夜景 发现 河 对面 南津关 的 夜景 很 有 味道 站 在 江边 吹 吹风 结果 回来 的 时候 天公不作美 下 暴雨 其实 南津关 真的 很 美 反而 古城 里面 现代化 的 招牌 太多 总 感觉 没有 了 古城 的 味道 这个 是 最 遗憾 的 随处可见 的 霓虹灯 招牌 大大降低 了 我们 的 趣味 相对 南津关 倒 显得 有 韵味 一点 不过 人 很少 牵着 心爱 的 人 走 在 古城 的 街道 上 简简单单 走走停停 累 了 就 歇息 妙哉 妙哉 不过 阆中 古城 是 十大 古城 之一 它 的 美 在于 古色古香 如果 充斥 着 大量 现代化 的 招牌 、 工具 、 桌椅 我 想 我们 以后 应该 不会 怀念 这个 古城 因为 它 再 这样 下去 已经 失去 它 的 韵味 了 个人见解 下面 附上 几张 南津关 照片 有 兴趣 的 朋友 可以 去 走走 虽然 古城 都 是 差不多 的 风景 但是 总有 它 独特 的 味道	__label__2
没滑过 雪 没 对比 整体 感觉 不错	__label__2
正常 花期 应是 每年 月底 到 月初 但 由于 今年 当地 天气 原因 花期 提前结束 整个 景区 就 成 了 现在 绿茵茵 的 景象 失望透顶 ( 汗 )	__label__2
如果 你 来自 西藏 也许 会 觉得 还 美的 失望 至极	__label__1
携程 订 的 登山 杖 非常 垃圾 中 泰 酒店 及其 偏僻 打电话 去 前台 问 各种 不耐烦 点到 了 指定 地点 人 都 没 一个 换 东西 搞 半天 浪费时间 一天 心情 全 糟蹋 了	__label__1
周末 刚去 挺 失望 的 停车场 边 的 卫生间 太 生态 了 要不是 小朋友 内急 绝不会 去 好 的 方面 就是 孔雀 挺 给面子 开屏 的 好久 一旁 的 鸽子 挺 亲近 的 但 跑 几十公里 去 还是 不值 个人 觉得 还是 管理 缺乏 个人 觉得	__label__2
除了 晒 就是 晒 外加 排队	__label__2
年 去过 一次 这次 再 来 更加 商业 了 不 喜欢 这样 的 地方 还要 收 古城 维护费	__label__2
一次 糟糕 的 出游	__label__1
岳阳楼 景区 的 门票 性价比 很 低 那么 贵 的 一张 票 就 只有 岳阳楼 是 唯一 值得 看 的 登 岳阳楼 观 洞庭 水 可惜 的 是 湖上 一片 白茫茫 的 啥 都 看不清 感受一下 千古 名楼 还有 就是 在 岳阳楼 里面 写 明信片 也 是 极好 的 岳阳门 也 值得一看 而 诸如 其他 五朝 楼观 岳阳楼 在 唐宋元 明清 五代 的 模型 双公祠 范仲淹 和 腾 子京 三醉亭 、 碑廊 、 仙梅亭 、 怀甫亭 、 醉仙阁 、 吕仙祠 、 小乔墓 、 蜡像馆 实在 没 啥 看头	__label__2
里面 的 景色 是 不错 的 也 很 有 特色 作为 一种 文化 保护 收 门票 是 对 的 但是 收 这么 高 的 门票 确是 不 值得	__label__2
除了 累 还是 累	__label__2
梦想 号 和 想象 中差 很多	__label__2
没玩头	__label__2
又 贵人 又 多	__label__1
晚上 一点 从红门 登山 到 中 天门 时本 以为 走 完 了 大半 谁知 才 仅仅 是 三分之一 最好 不要 走 的 太快 否则 体力 很 容易 透支 在 外边 花 了 块钱 买 的 手电筒 到 了 中 天门 就 没电 了 又 花 了 快 买 的 电池 最气 人 的 是 到 了 观日台 好不容易 爬上去 了 结果 因为 阴天 看不到 了 害 的 上千人 苦 等 一	__label__1
悠闲 休息 好去处	__label__2
无处可去 的 场所	__label__2
暑假 去 的 我 真的 要 在 大 太阳 底下 晒 晕 了 至少 排 了 两个 小时 队 进去 参观 顶多 三分钟 就 被 人潮 推出 来 了 时间 成本 太高 完全 不值 除非 对 伟大领袖 抱 有 朝圣 的 心态 否则 还是 不必 去 了	__label__2
差评 很 差 很 差太累 需要 休息 五天 山上 的 大衣 太湿	__label__1
不 知道 为什么 一个 南传 佛教 的 地方 到处 都 搞 的 是 藏传佛教 的 东西 而且 转经筒 里面 没有 经书 导游 还 一个劲儿 的 让 我们 卖 带有 金色 佛牌 的 门票 还装 的 挺 像 回事 的 既然 是 不二法门 众生 平等 那 不同 等级 的 门票 又 有 什么 区别 呢 不 喜欢 国内 一些 只要 跟 佛教 沾边 的 景点 老 喜欢 弄 一些 转经筒 跟 青海 西藏 相比 觉得 真是 一点 意义 都 没有 绕 观音 顺时针 走 几圈 就 好 了	__label__2
实在 单调 不太 适合 孩子	__label__1
真的 真的 有 些许 失望 特意 买 了 票 可是 可是 最忆 是 杭州 已经 不是 原来 的 印象 西湖 了 主线 不 清晰 主题 散乱 我 最 爱 的 张靓颖 的 歌 也 没 了 就 像 个 央视 主旋律 玩会 恨不得 来个 难忘 今宵 才 过瘾 来 杭州 的 朋友 诚意 推荐 宋城 的 千古 情 演出 惊喜 不断 超乎 想象 印象 西湖 就 别来	__label__2
就是 名气 大 · · · 没什么 · · · 看 图片 就行 · · ·	__label__2
票价 多 性价比 来说 真心 不 值得 真心 不 推荐 周边 还 没建好 比较 乱	__label__2
山洞 的 景色 挺美	__label__2
绝对 大坑 开 了 好 远车 过去 跟着 高德 地图 走上 了 一条 坑坑洼洼 的 沙土路 只有 大约 两 车道 宽 过往 的 全是 渣土 车 小车 开着 十分 惊险 车辙 很深 地上 的 石头 不时 刮到 底盘 到 地图 显示 还有 到 景区 时候 没有 路 了 只好 返回 返回 到 公路 以后 发现 有 一行 油漆 写 到 字 说 景区 整修 封闭 不 开放	__label__1
有 很多 卖 古董 的 有 超级 大 的 商场 也 有 批发市场 的 小 摊子 卖 一些 工艺品	__label__2
对 云南 我 已经 不想 多 说 什么 了 即使 我 没 跟 过团 也 觉得 那里 就是 一个 大坑	__label__1
不 值得 推荐 来 北京 旅游 最差 的 一个 景点 一点 都 不好 在家 百度 都 知道 的 东西 而且 价格 真的 太坑 了 就是 花块 请 导演 讲故事 而且 每个 场景 停留 不到 分钟 匆匆忙忙 转 一圈 出来 都 来不及 拍照 就 到 出口 了 里面 到处 是 广告 漫天要价 的 一 出来 就 不 可以 再 进去 入场 的 时候 也 没有 告知 是 单向 参观	__label__2
还成 去 时 蜡像馆 没开 只 看 了 看 球场 坐在 观赛 座位 上 感受一下 一张 票 不值	__label__2
空白	__label__1
太小 太小 太小	__label__2
一个 不大 的 艺术馆 由 黄胄 创办 有些 馆 被 用作 北京 青少年 的 活动 和 展览室 一个 很 大众化 的 艺术馆	__label__1
很 恶心 人 来回 的 公交车 被 私人 承包 了 乱收费 很 不爽 景色 也 一般 当地人 很 不 纯朴 是 重庆 之旅 最 难受 的 一个 景点	__label__2
在 这里 待 了 年 感觉 不好玩 没有 厦门 好 的 多	__label__1
二月 一号 去 的 黄山 携程 上 看到 都 是 免费 的 说 包函 在 门票 内 的 买 了 门票 和 索到 从前 山上 的 几百米 路 排队 排 了 有 两 小时 到 了 光明顶 路口 不让 上 说 要 买票 一张 这 不是 坑人 吗 花 难道 只是 从前 山上 后 山下 走 一下 山路 而已 这 是不是 贵 的 有点 离谱	__label__1
永定河 河道 中 的 水库 之一 很久以前 去 钓过 鱼 现在 不让 了 没什么 看 的	__label__2
它 的 风景 对不起 这个 门 票价 讲真 啊 大年初二 去 的 人太多 很多 东西 人一多 就 不美 了	__label__2
就 一破 茅草屋 还是 卖东西 的 地方 简直 无法 忍	__label__2
景点 不错 景区 服务 跟不上	__label__2
很贵 很 贵 很 贵 很 贵 很 贵 很 贵 很 贵 很 贵	__label__2
端午节 第一天 去 的 猛兽 区 一路 自驾 除了 几只 熊外 什么 散养 的 猛兽 都 没 看到 白虎 园过 了 停车 区 几只 圈养 的 老虎 小 动物 区 好多 笼子 都 是 空 的 感觉 运营 的 不好 大概 快 十年 前去 过 一次 那 时候 动物 挺 多 环境 也 比 现在 强多 了 这次 去 看 动物 的 圈养 环境 很脏 猴山 的 水 都 是 绿 的 感觉 一定 很 臭 总之 很 失望 因为 之前 印象 不错 而 在 北京 野生 动物园 和 八达岭 野生 动物园 之间 选择 了 后者	__label__1
旅游 城市 打 出租 秩序 还 行会 排队 但是 人多	__label__2
如果 想 看 银杏 去 香山 植物园 吧 这 就是 一条 路 没 几颗 银杏树 特别 的 坑 不 要求 一点 不 推荐	__label__2
住宿 贵 吃饭 贵 没 办法 去 敦煌 方向 这是 第一个 休息区 大家 凑合着 吧	__label__2
无止境 的 排队	__label__2
景区 感觉 很 坑 给 人 印象 是 山海关 的 文化氛围 少之又少 票价 而且 还 不 固定 难怪 被 取级 景区	__label__2
给 哈哈哈哈 哈哈哈 ╰ ‵ □ ′ ╯ ✧ 送 你 五毛钱 特效	__label__2
自由 行 建议 不要 去 如果 去 了 也 不要 去 坐 电动车 有点 坑	__label__2
下次 不会 去 了	__label__2
里面 的 都 是 奸商 胡乱 开价 宰有客 江心屿 里面 根本 没什么 玩 的	__label__1
从 花都 过去 坐车到 西樵 新 汽车站 等 了 半小时 坐上 樵 到达 北门 北门 没有 缆车 过年 期间 电瓶车 只 送到 天湖 所以 选择 了 徒步 上 山路 没有 分开 人行 和 车行道 小车 跟 电瓶车 在 身边 呼啸而过 太 危险 了 空气 也 被 汽车 废气 污染 了 山脚 的 碧玉 洞封 了 走 了 大半 小时 除了 百步 梯 没有 任何 一个 景点 山景 也 并 不 好看 因为 赶时间 回去 走 到 一半 放弃 了	__label__2
下雨天 人少 工作人员 服务 挺 好 态度 也 很 好	__label__2
因为 没有 时间 去 退票 都 退 不 掉 既然 退不掉 又 何必 让 人 等 一天 又 一天 退款 时间 一次 又 一次 拖延 就 想 说 第二天 再 黄山 售票点 买 的 票 黄山 很美到 以后 在 也 不 去 了 有点 店大欺客 的 感觉	__label__1
十一 期间 用 两天 时间 顺序 去 了 平遥 古城 、 王家 大院 和 乔家大院 没 比较 没 鉴别 乔家大院 最 票价 离谱 是 王家 大院 的 倍 没 了 古韵 修旧 如 现代 太 商业 气 出口 摊贩 点 一眼 望 不到 头 如 点评 一个 字差 两个 字 失望 三个 字 上当 了	__label__1
说 说 我 自身 早上 的 经历 在 北京北站 买不到 的 票 心里 想大 北京 应该 治安 还行 在 门口 上 了 说 来回 元 的 大巴 走 了 大巴 终于 凑足 多人后 大巴 启动 刚 开始 售票员 态度 很 好 接着 在 路边 停靠 上 了 两个 类似 黑社会 的 人 开始 恐吓 我们 说 北京 地儿 警察 没用 他们 地头蛇 才 是 主儿 还要 我们 继续 交多 一路 恐吓 我们 被 吓 到 后 有 个 人高马大 的 朋友 开始 拔 司机 的 钥匙 四个 地头蛇 开始 向 我们 攻击 接着 那个 朋友 说 跳窗 走 逼 停 大巴 我们 全部 下车 后 我们 报警 了 以后 朋友 们 千万 不要 去 那里 坐 大巴 车牌号 如下	__label__1
完全 就是 仿建 毫无 新意 且 人气 不足	__label__2
慕名 而 去 失望 而 归 一点 意思 都 没有	__label__2
特别 差 的 景区 不仅 是 风景 不值 三十块 门票 人 也 很 不 厚道 首先 一个 破湖 跟 家门口 免费 公园 的 水塘 子 似的 愣 是 收 门票 最 恶心 的 是 不 交钱 你 连 水影 都 看不到 用 超级 高 的 墙 把 湖 四周 都 围 的 特别 严实 大概 是 靠 门票 钱 和 超贵 的 娱乐 项目 收费 来 填补 盖墙 的 钱 吧 抱 着 是 大老远 来 了 平谷 搜 了 这个 景点 不去 一下 可惜 结果 了 吗 到 了 还 差 几分钟 景点 下班 跑 去 售票点 问 快下班 了 还 收费 吗 看似 正规 的 穿 西装 的 女 售票员 答道 收 啊 三十 我 问 那 等会儿 下班 了 还 收费 吗 女 售票员 答道 下班 也 有 值班 的 拿 钱 就 在 两个 人刚 交 了 六十 门票 进门 的 瞬间 后面 乌拉 拉进来 了 大概 有 一百多 人 完全 没 交钱 就 进来 了 才 知道 这个 点 了 根本 不要 钱 了 这 才 得知 我们 被 那个 女 售票员 骗 了 自此 对 平谷 这个 地方 完全 失去 了 好感 之前 看 点评 说 平谷 景区 价格 都 偏贵 这次 游 平谷 发现 真的 就是 这样 那个 京东 大峡谷 也 是 门票 加 捆绑 消费 的 项目 加 起来 也 有 近 五百 了 国家 五 景区 也 不 这个 价吧 至于 金海湖 的 风景 看图 吧 因为 快 六点 进来 的 那天 也 有 雾 霾 加上 被 售票员 不 厚道 的 拿走 六十块 钱 对 它 印象 非常 差 拍 了 两张 照片 好好 的 湖景上 一定 会 横 着 两条 缆车 的 线	__label__1
差评 景色 不错 管理 和 服务 太 差 景区 工作人员 骗 游客 的 现象 很 严重 本来 就 有 免费 的 大巴车 工作人员 任 你 怎么 问 也 不会 告诉 你 晚上 六点 以后 更为 猖狂 无奈 只能 购买 元 乘坐 公里 的 观光 电瓶车 大 冬天 在 无门 无窗 的 车上 冻得 发抖 严重 败坏 无锡 的 城市形象	__label__1
让 人 感觉 不 值得 的 旅行	__label__2
只能 说 是 很 垃圾 的 景区 门票 同程 优惠 一点 但 仍 不 便宜 当 你 买 了 门票 进入 景区 之后 你 会 发现 你 面临 一个 选择 要么 买 船票 进入 核 景区 要么 随便 玩玩 滚蛋 只好 选择 买 船票 每人 买 了 买 了 船票 之后 你 会 发现 更 扯淡 了 售票员 告诉 你 你 要 再 买 返程 船票 要 不 买 就 没 办法 回来 了 因为 路断 了 反正 只要 你 上 了 船 你 就 只能 被 宰 反正 只要 你 来 了 这元 是 必须 花 的 坐船 票价 含 什么 屁 也 不 含 你 以为 真是 还有 讲解 你 想 多 了 下 了 船 看 什么 什么 也 没有 这样 说 吧 郑州 紫荆山 公园 也 比 这里 漂亮 可能 每人 审美 不 一样 钱 多 不怕 坑 的话 来 看看 另外 自驾车 在 离 景区 很远 的 地方 就让 你 停下来 停 在 路边 也 必须 交元 停车费 然后 会 有 电瓶车 每人 元 带你去 买票 不 坐 也 可以 腿 着 走 买 了 票 进门 还是 电瓶车 继续 买 返回 返回 当然 继续 买票 喽 吃饭 贵 厕所 环保 开了个 其他 全部 维修 哈哈 你 想 水边 走走 又 想 多 了 维修 哪线 一拦 想 过 飞过去 这个 景区 影响 到 了 我 对 焦作 的 看法 恶劣 垃圾 差评	__label__1
我 买 门票 付 了 双倍 的 价钱 还有 缆车 好 不 安全 别 做	__label__1
环境 还 可以 就是 里面 东西 太贵 让 游客 不敢 接受	__label__1
服务 好差 还 坑人 租 大衣 在 山下 说 上山 贵 山下 二十 山上 要 几十 上 了 山 才 知道 上山 元 泰山 山顶 宾馆 就是 一个 见钱眼开 的 吸血鬼 日 凌晨 下雪 开始 登山 的 客人 要 进去 收元天 冷 还 不开 暖气 更 过分 的 是 后来 的 客人 直接 收元 这 老板 丧尽天良 祝 他 生子 没 屁眼 优点 还	__label__1
感觉 两个 坑字 怎么 了 得到 过 了 以后 也 不会 去 了	__label__2
景区 除了 大门 好看 没有 可看性 破败 的 样子 没 怎么 维护 元 的 票价 高 的 离谱	__label__1
非常 不 推荐 我们 就是 转 了 转 没有 什么 特别 的 东西	__label__2
不 咋样 放 了 人工 冰块 没 那么 冷 让 你 租 衣服 元	__label__2
浓浓的 商业 味 已经 沦为 普通 的 商业区	__label__2
没什么 可看 的 只不过 就是 有些 人 没有 出国 看 一下 这是 世界 公园 的 微缩 景观 而已 到此一游	__label__2
外场 布置 还行 大 马戏 等 我 表演 略过 简单	__label__1
点评 得 有点 久 了 只 记得 是 环 西湖 的 一处 景点	__label__2
见到 了 停车场 收费 元 还 以为 到 了 景点 人家 说 还有 一段距离 可以 坐 电瓶车 过去 其实 景点 那边 有 停车场 自驾车 完全 可以 驾车 过去 花元 坐 电瓶车 没 必要 通票 元 另外 回收 元 邮费 不知 为什么	__label__2
服务 一塌糊涂 景色 没有 除了 日出日落 看 下 几分钟 其他 一无是处 不 推荐	__label__1
不 值得 一去 照片 是 骗人 的 和 奥体 森林公园 差 一条 万里长城 天气 不好 的话 还 不如 小区 的 绿植	__label__2
和 杭州 的 一样 不会 再 去 了	__label__1
有点 无聊 的 行程	__label__2
大峡谷 好难 玩 不 推荐 白花 多 门票 个人 还 不如 去 欢乐谷 无聊 至极	__label__1
购物 一条街 可以 作为 中转站 买点儿 特产 什么 的	__label__2
一个 字差	__label__1
龙潭山 登上 后 可以 看到 吉林市 全貌 和 松花江 湾	__label__2
服务态度 和 卫生 有待 提高	__label__2
月 中旬 去 的 天气 略微 有些 晒 但 并 不太热 骊山 现在 与 华清池 合并 为华 清宫 景区 门票 元华 清宫 位于 西安 的 临潼区 在 西安站 东 广场 有 公交 和 旅游车 直达 华 清宫 和 兵马俑 价钱 差不离 如果 是 自由 行 不 喜欢 受 拘束 建议 坐 公交 速度 相对 快 如果 为了 省心 省事 的话 可以 选择 旅游车 有 同行 的 导游 和 司机 但 相应 的 会 受到 拘束 个人 不 推荐 去华 清宫 这个 时间段 游客 太 多 无法 好好 欣赏 同时 景区 化太 严重 也 没有 太 多 历史 文化 价值 全是 后期 修建 的 人文 建筑 的 堆积 不太有 去 的 必要	__label__2
去 的 时候 没花开 所以 两颗 星 维护 设施 也 做 得 很 一般	__label__2
之所以 有趣 也 只不过 因为 它 存在 于 鲁迅 的 童年 回忆 中 而 对于 我们 来说 只是 重新 呈现 课本 中 的 一草一木 于 我们 没有 任何 意思 而 显得 无趣	__label__2
人多 风景 还好	__label__2
快乐 一天	__label__2
传闻中 漓江 水质 清澈 著名 的 桂林山水 就 在 漓江 上 不 知道 是不是 旅游 不宜 时 有点 令人 失望 并 不 符合 想象 中 的 场景 细问 之后 据说 年 污染 破坏 愈发 严重 毫不 夸张 的 说 我 去 旅游 那 几日 不但 没 欣赏 的 清澈 的 水 满眼 尽 是 污浊 的 漓江	__label__2
只能 说 交通 非常 不 便利 一辈子 只 体会 这 一次 服 了	__label__1
总而言之 真的 一般般	__label__2
个人 觉得 很 坑 的 一个 景点 没有 特色 没有 令 我 着迷 的 地方	__label__2
都 已经 关闭 此岛 了 为什么 不 删除	__label__1
有点 坑人 了 没有 去 以为 跟 其他 美团 一样 自动 退票 呢 结果 自动 付款 了 真是 醉 了	__label__1
觉得 和 大连 的 商业街 没有 很大 差别 没 发现 什么 特色 就是 购物 的 地方	__label__2
本来 就是 太湖 边上 一个 大 公园 而已 因为 出名 收 太贵 的 门票 不 值得 去 了 小时候 去 无锡 扫墓 完毕 都 会 去 几个 公园 转转 鼋头渚 、 蠡园 等 都 是 很 有 江南 味道 的 公园 门票 也 不是 很 贵 现在 太 湖水 很脏 很 臭 鼋头渚 收 这么 贵 的 门票 根本 不 值得 去 太湖 大道 边上 走走 就 可以 了 而且 鼋头渚 比起 杭州 西湖 也 是 差远了	__label__2
门票 块 兼职 太坑 了 而且 以为 景区 里面 很大 要 坐 摆渡 车 还 花 了 块 其实 景区 特别 小 走走 也 就 分钟 摆渡 车有 一种 是 小 火车 的 工作人员 为了 省钱 还 不让 坐 都 让 坐 那种 透风 的 小车 冻死 了 景区 风景 基本 相当于 没有 什么 就是 延伸 出 码头 看看 青海湖 要 想 去 湖心 山 还要 单 花钱 坐船 块 门票 干什么 了 啥 都 没有 啊 太坑 了 啊 想 近距离 看 青海湖 的 朋友 们 还是 直接 找个 牧民 给 块 到 边上 感受 感受 得 了	__label__2
相传 是 黑 北京 一日游 的 必到 景点 质次价高 自己 去 便宜 不少 但 也 不 推荐	__label__1
就是 娱乐 花钱 的 地方 没什么 可玩 的	__label__2
这个 景点 在 景区 之外 没事 有 门票 还是 能进 得来 或者 六点 后	__label__2
在 七八十 这 条 年代 这里 可以 算是 一条 金街 你 需要 什么 东西 在 这里 基本 都 能 找到 现在 条街 算是 坑爹 一般 都 说 你 跟 谁 有 仇 就 在 这里 买 东西 送 她	__label__2
文化 广场 放风筝 在 文化 广场 滑旱冰 在 文化 广场 喂 鸽子 在 文化 广场 逛 书市 在 文化 广场 学过 骑车 在 文化 广场 跳绳	__label__2
还 可以 西 海子 公园 离 通州 电影院 非常 近 希望 大家 一定 要 去 呀 	__label__2
庐山 依然 存在 园中园 票中票 现象 国庆 去 了 一趟 上 山前 在 上 脚下 购买 门票 元人 若 要 游览 庐山 瀑布 行至 含鄱口 处需 穿过 一个 什么 谷 的 地方 才能 到达 瀑布 景区 这个 所谓 的 谷 被 当地 称作 谷 景区 再 加上 庐山 瀑布 需收 门票 元 含元 保险 另外 所谓 的 三叠 泉 也 比较 一般 实事求是	__label__2
两次 了 影响 情绪	__label__1
说实话 大唐 芙蓉 园是 去 西安 觉得 最坑 的 地方 的 门票 人造 景观 没有 任何 意义 可言	__label__2
不 值得 本地人 免费 里面 很多 地方 都 没有 开放 但是 门票 一份 没有 少	__label__2
各种 坑爹 性价比 极低 景区 停车场 按 小时 收费 一 小时 块 尼玛 上海市 区 不过如此 岛上 门票 捆绑 销售	__label__1
我 朋友 在 网上 买不到 票去 窗口 买 了 结果 那 售票员 语气 特别 差 还 黑 着 脸 可 吓人 了 天呐 再也 不敢 来 了 里面 现做 的 东西 超级 贵 而且 接 一口 水要 五块 钱 呢 真心 不敢恭维 这 地方	__label__1
国庆 期间 能 到 此 留念 的 完全 可以 称得上 好汉 一枚	__label__2
一个 级 景区 历史 上 的 地位 比较 高 现在 景区 内 的 芙蓉 园 还 算行 吧	__label__2
其实 中国 的 大部分 景区 都 要 比 盘山 景区 静 的 优美 来 天津 还是 市区 内 的 人文 景色 要 更加 吸引 人	__label__2
实际 没有 宣传 图片 好	__label__2
春节 去 的 北方 大雪 他 那里 下雨 当时 风 特别 大 没 坐船 挺 遗憾	__label__2
青藤 书屋 不 建议 去 两个 房间 一个 是 座椅 一个 是 字画 一眼 看 完 两分钟 搞定	__label__2
就是 一 步行街 有 购物 欲望 的话 可以 去 溜达 溜达	__label__2
别 被 网上 的 照片 忽悠 了 天池 说穿 了 就是 一个 池子 其它 没什么 风景 太 一般 处处 是 人工 痕迹 一圈 下来 一个 小时 门票 收坑 的 要死 按照 这种 程度 门票 最 多元 我 不是 个 挑剔 的 主 但 这种 破 地方 也 要 收费 呵呵	__label__1
来 之前 专门 做 了 功课 查 路线 需要 线 因为 住 动物园 附近 早晨 点多 叫醒 孩子 和 老婆 收拾 东西 去 赶 地铁 到 北京北站 时 : 左右 立刻 排队 准备 进站 当 我们 前面 有 左右 人时 很 不幸 通知 列车 已经 满员 需要 等查 了 一下 : 泪奔 啊 好 吧 我 等 第一趟 开走 大约 一会 检票 进站 找到 位子 之后 发现 没有 人 坐 有人 直接 排队 了 好 吧 我们 也 排 吧 后面 越 拍 越 多 老人 、 小孩 都 挤 着 往后 一看 人 确实 不少 苦苦 等待 近 : 时 开始 放行 了 前面 的 一窝蜂 冲 了 进去 我 进去 一看 火车 好远 啊 拎 着 包 牵 着 孩子 手 一顿 猛 跑 天 哪 跟 打仗 一样 好 可怕 冲 上车 到处 找 座位 稍晚 一些 就 没 坐 了 坐下 后 孩子 说 爸爸 我 心跳 的 好 快 啊 一路 还有 上车 的 全是 站 着 的 再 来说 说 返程 提前 一个半 小时 赶到 火车站 全面 近人 还 比较 乐观 慢慢 人 越来越 多 一圈 一圈 的 等 车站 着 腿 好 累 放行 后 又 是 一顿 猛跑 脑中 一个 想法 跑 到 最 前面 就 可以 了 好 了 到 一个 地方 排好队 前名 看看 就 能 乌 压压 一片 人 感觉 还 挺 好 一会 乘务员 说 了 一句 让 我 吐血 的话 基本 第一节 车厢 有座 其他 始发站 就 满 了 果然 上车 傻眼 一路 站 回来 这 一路 下来 脚疼 腿疼 来回 坐车 给 人 的 体验 太差 了 看到 车上 的 老人 、 小孩 百感交集 试问 相关 管理 部门 你们 这是 什么 作为 明 知道 会 有 很多 人 为什么 不 加开 列车 什么 的 深感 无奈 特别 是 刚 看 网易 说 晚上 还有 很多 人 在 八达岭 车站 心里 更 不是 滋味	__label__2
景点 一般般	__label__2
特别 想 挖开 看看 到底 是不是 独臂	__label__2
广告 是 做 得 十足 演出 实在 是 看不下去 建议 去 泰山 的 朋友 不要 去 先 说 演出 第一 舞蹈演员 一 不 化妆 发式 也 随意 一个 头套 戴 在 头上 就算 完事 了 演到 清朝 时 演员 额头 前 好多 流海 还 扎 马尾 上场 鞋子 也 是 不 专业 黑 布鞋 是 好 的 还有 厚底 皮鞋 的 第二 舞蹈 毫无 美感 演员 不知	__label__1
全差 如果 你 没 看过 海 甚至 湖 那 就 来 吧 我 看过 北京 香港 蓬莱 还有 几处 不 说 了 这个 是 最差 的 海豚 表演 一直 是 几个 外国人 搞笑 海豚 和 白鲸 就是 过场 尽然 人山人海  卖东西 和 吃饭 的 地儿 真多 不 好吃 缆车 就 分钟 吧 到头 分钟 往返 最 要命 的 是 到 入口 要 爬山 两边 都 要 爬 要 了 亲命 啊 特意 周一 来 玩 还 那么 多人 差评	__label__1
费用 陷阱	__label__1
讲真 这 就是 两座 亭子 啊 而且 是 后来 造 的 大家 就 不要 浪费 钱 啦 爬上爬下 多累 啊 省点 体力 看 别的 啊 当然 如果 特别 喜欢 历史 的 人 可以 去 看看 人文 情怀 嘛 同行 的 小伙伴 有 上去 人不多 外景 在 车上 就 可以 看到 山上 风 比较 大 注意 保暖	__label__2
有些 人工 的 风景 感觉 其实 就是 个 大 公园 不太 喜欢 主要 是 历史背景 太 显著 了 所以 吸引 了 很多 游人 前往	__label__2
科技馆 顾名思义 应该 是 领先 于 现在 的 科学技术 的 教导 类 场所 但 为什么 去过 之后 满满的 问号 这 都 是 什么 年代 的 东西 啦 也 太 落伍 了 吧	__label__2
到此一游 患者 的 最 爱 除此之外 没有 任何 特殊 之处 交 了 一元 钱 以后 你 会 发现 前面 一排 现代化 的 厕所 只是 摆设 最终 还是 要 绕 到 后面 的 简陋 茅房 去	__label__2
护国 随粮 王庙 供奉 的 是 西塘 的 地方 神	__label__2
黑黑 黑 里边 除下 风景 好看 以外 真 没有 别的 优点 了	__label__2
我 是 风景园林 专业 的 学生 所以 对 园林 很感兴趣 这次 圆明园 成为 了 我 北京 园林 的 第一站 结果 却 大失所望 没想到 真的 是 扎扎实实 的 一片 废墟 坑 死 了 全都 是 光秃秃 的 哪 哪 都 是 一片狼藉 学 风景园林 的 真的 可以 不 用来 了 你 会 特别 失望 建议 学 想象 学 的 可以 来 发挥 强大 的 想象 能力 看着 几块 石头 几片 土坡 去 想象 一下 百年 前 的 万园 之园 实在 没事 可以 来 逛一逛 千万别 请 导游 也 别 租借 讲解 器 只有 两个 区 勉强 开放 逛 一圈 个 小时 足够 了	__label__1
外双溪 索道 收费 停车 的 管理员 污蔑 我 刮 蹭 了 临近 的 车子 扣下 我 的 车辆 行车证 不 给 不让 我 走 还 准备 叫 人 堵 我 为 避免 影响 旅游 心情 和 麻烦 无奈 只好 给 他 游玩 结束 被 告知 要 元代 为 赔偿 费用 让 他 给 我 所谓 被 刮蹭方 的 联系方式 借口 不 知道 最终 交涉 要 了 我 元 为 留下 证据 我选	__label__1
跟团 多加 出来 的 点 挺 无聊 的 而且 也 都 是 人为 建 出来 的 地方 不 推荐	__label__2
浪费 钱	__label__2
天下第一 坑 还 门票 我 看 最多值 块钱 门票 非常 之差 其中 一个 需要 买票 才能 进去 的 景点 进去 一看 只有 一张 诸葛亮 的 画像 要 去 建议 逃票 进去 不值 票钱 景区 门口 沿路 往 左 一直 走当 看到 前方 出现 当地人 设卡 收费 点 的 时候 可以 从 田间 小路 进 景区 或者 进 游客 服务中心 到 检票口 前面 时 左边 是 厕所 这时 往右边 走 在 拐角 是 卖 土特产 的 商店 直接 穿过 商店 就 进 了 景区	__label__1
本来 我 这个 人懒 不太爱 写 攻略 的 但是 这里 真的 太坑 爹 了 去 旅行社 订 的 时候 告诉 我们 游 全程 船开 到 阳朔 结果 船开 了 三分之一 不到 就 回来 了 上岸 坐车去 阳朔 一个 人 还 收 打电话 给 旅游局 投诉 也 没 人理 到 那个 龙潭 古寨 里面 的 讲解 一直 在 介绍 银子 的 好处 我们 不爱 听 结果 就 说 你们 不 听 我 讲解 你们 待会 转 两个 小时 都 走 不 出去 把 一 屋子 人 扔 那里 素质 实在 太差 真 搞不懂 桂林山水 甲天下 旅游 服务 这么 差 物价 监管 混乱 同一个 路线 同一 车人 有人 有人 关键 收 了 还 不让 你 看到 最 精华 的 风景 漓江 的 水 也 没有 传说 中 的 那么 好看 水 里 好多 杂物 比 贵州 景区 管理 差 的 太 多 了	__label__1
很 一般 就是 很 一般	__label__2
很漂亮 的 地方 南京 著名景点 我 是 跟 华东 五市 游 的 团去 的	__label__2
乐园 有些 项目 还 没有 开放 服务 不 到位 票价 高 携程 服务 不错 方便	__label__2
一般 不会 再 来	__label__2
不 知道 该 怎么 形容 我 的 失望 想象 中 安详 、 静谧 的 古村落 景致 倒 是 和 宣传 照片 没有 太 差 只是 只有 身在其中 才能 感受 到 到底 有 多 拥挤 多 嘈杂 充斥 着 商业化 和 浮躁 的 情绪 甚至 比 城市 更 甚 池塘 里 的 水质 也 很 差 摩托车 不住 鸣笛 在 满 是 行人 的 狭窄 巷子 里 穿行 真不该 对 这种 名声在外 、 开发 多年 的 景点 抱太大 期望 从 汤口 坐 班车 到 宏村 的 小巴 每天 有 上午 八点 多 和 中午 一点 四十两 班 每人 元 沿路 招手 即 停 返程 收车 很早 票 早早 就 卖完 了 据 当地 宾馆 老板 介绍 包车 往返 平日 里 左右 节假日 翻倍 可以 说 是 漫天要价 我们 返程 单程 就 被 收 了 多 沿途 堵车 非常 严重 小巴 距离 宏村 公里 左右 就 堵住 了 现在 想想 倒 是 沿 公路 那 公里 徒步 满 有 感觉	__label__2
没 去过 都 想 去 去过 就 后悔	__label__2
性价比 超低 的 景点	__label__2
岳麓山 本身 就 什么 都 没有 只是 有个 爱 晚亭 估计 出名 也 就是 因为 题字 的 人 亭子 是 新 的 很 无聊	__label__2
总算 知道 啥 叫 管理混乱	__label__2
主要 是 冲着 植物园 去 的 植物园 里面 还是 很 不错 的 里面 有 各种各样 的 植物园 热带 水果 仙人掌 有 一 大片 拍 了 很 对 照片 成熟 的 水果 都 包 起来 了 可以 花钱买 一个 留念 就是 小 贵点 门票 一张 出 了 植物园 就 没有 什么 好玩 的 了 里面 物价 还 挺 贵 的 过节 了 图个 开心 性价比 不高	__label__2
看 了 评论 不敢 去 了 没想到 这里 变成 这样 了 年 当兵 时 连长 带 我们 参观 过此 洞 那时 没有 开发 当地 老百姓 打着 火把 照明 洞 很大 很 壮观 我们 只 看 了 一层 今年 国庆 想 回去 怀念 一下 看看 当年 的 军营 顺便 看看 开发 以后 的 石花洞 没想到 看 了 评论 景区 管理 如此 混乱 不敢 去 了	__label__1
去 灵隐寺 还要 另外 花元 买票	__label__2
虞山 之 旅	__label__2
景色 非常 不错 早 只有 盘山 何必 下 江南	__label__2
只有 美术馆 不需 买票 其余 体验 的 全 需要 买票 而且 价格 很 高 不 推荐 大家 购买	__label__2
五大连池市 五 大连市 风景区 极差 评 今天 打 出租车 去 五大连池 老黑山 景区 结果 出租车 司机 把 我 送 了 堰塞湖 景区 收 了 车费 后来 发现 不 对 明明 要 去 山 的 怎么 是 湖 、 司机 不仅 不 承认 送错 了 地方 说 什么 到 老黑山 只能 水路 不能 陆路 除非 他 车子 能 游水 才能 到 老黑山 景区 还 找 了 一个 其它 的 司机 装做 景点 的 工作人员 给 他 做 证明 但是 任何 景点 的 旅游 图 都 有 啊 明明 可以 陆路 去 老黑山 的 最后 就是 他 走 了 我 就 只能 回走 了 从 堰塞湖 回到 风景区 入口 有 公里 觉得 这是 明显 的 诈骗 行为 其中 我 在 路上 两个 景点 处问 景点 工作人员 回去 的 大巴 哪里 坐 景点 售票员 说 问进 景点 口 的 工作人员 进 景点 口 工作人员 说 这个 要 问 停车场 停车场 的 工作人员 说 你 打车 吧 没有 大巴 打车 呵呵	__label__1
看 表演 的 人 很多 表演 也 很 好看 最好 的 就是 海狮 表演 了 它 非常 的 活泼 也 很 乖巧	__label__2
有点 失望 南靖 的话 也 是 一样 的 只要 是 去 土楼 最好 自己 去 跟 的 一日游 当地 团 导游 没 问题 就是 我 应该 在 龙岩 住 一晚 一大早 就 坐车 前往 景区 一 小时 游览 结束 坐火车 到 厦门 快得 很 可惜 啊 早上 肯定 没 人 旅行社 都 是从 厦门 过来 中午 才 到 整个 景区 游览 一 小时 绰绰有余 很小 拍照 就 了 不要 景区 讲解 尽 吹牛 逼 还 浪费时间 我 跟 她 说 我 想 自己 游览 就 签 了 个 协议 我 自己 游览 半小时 四十分钟 就 看 完 了 就 两栋 土楼 另外 即使 给钱 也 不能 让 居民 带 上楼 现在 都 有 保安 守 着 二楼 所以 没什么 意思 了 楼下 拍照 不 好看 拍 不到 全景 就 拍个 屋檐 带个 单反 很 失望 而且 还 雷阵雨 雨大得 全是 泥巴 整个 景区 两栋 房子 失望 学生票 便宜 但是 浪费 我 表情 啊 别来 了 拍 不到 好 照片 的 唉 一日游 团 基本 一天 都 耗 在 这 了 汽车 晚上 七八点 才 到 厦门	__label__2
没有 进去 知道 里面 就是 个 土包 所以 没有 进去 售票处 也 没人 买票 也 没 几个 人 进去 参观 大家 也 没 必要 进去 了	__label__2
这山 基本 没什么 特色 就 记得 一个 鼎	__label__1
后悔 去 了 这个 地方	__label__1
建议 去 拉脊山 的 就 不要 去 日月山 了 景点 收费 里面 啥 也 没有	__label__2
十个 包子 果然 狗不理 而且 东西 也 很 一般 百分之八十 都 一样	__label__1
就是 人多 性价比 太低	__label__2
高峰期 景区 分流 规划 严重 不合理 不 应该 从 早上 把 人 一窝蜂 全部 放进来 导致 换票 排队 进门 排队 等 转运 巴士 排队 等 缆车 排队 上山 排队 处处 排队 为啥 不 分 批次 一 波波 进入 呢 本来 可以 做 的 更好 就是 啥 也 不 做 体验 极差	__label__1
北京 的 一日游 相当 坑爹 协议 上 的 景点 没有 一个 好好 去 呢 强迫 购物 强制 自费 朋友 们 千万别 订 任何 价格 的 一日游 否则 你 会 把 肠子 都悔青 了 别跟我 说 参加 低价 团 就 这样 一个 人 说 高 不 高 说 低 也 不 低 了	__label__1
爬山 — — 天柱山	__label__2
性价比 非常低	__label__2
努力 的 想 把 自己 做成 南京路 的 一个 地方 结果 四不像	__label__2
一般 一般 一般 一般 一般 一般 一般	__label__2
点评 有奖 第季 观光 缆车 就是 套路 沿着 一条 山路 往下走 就是 让 你 去 做 缆车 做 了 缆车 才 没 几分钟 就 把 你 带到 了 山上 自己 还 得 下山 途中 做 索道 观光 缆车 真的 不 建议 去 做 没 必要 花 这个 钱 可以 去 其它 几处 地方 看看 发 风景	__label__2
从 三潭印月 岛 下来 路过 这里 很 清静 有 一些 故城 遗迹 残破 的 地基	__label__2
真心 没有 什么 意思 就是 一个 关了 的 圆形 的 寺庙	__label__2
梅雨季节 的 杭州 再也 不想 去 了	__label__1
这个 地方 还是 不要 是 去 了 首先 你 看不到 河 已经 被 截留 成 一个 小 池塘 了 没什么 风景 其次 这是 私人 的 价格 不止 最后 如果 你 想 穿 当地 衣服 拍 几张 照片 个人 的话 可以 进去 多 拍点 人多 的话 还是 算了	__label__2
故宫 的 一个 角落 照相 的 感觉 不错	__label__1
不 喜欢	__label__2
当地人 的 素质 差 到极点 无 管理 从 警察 到 摊贩 都 宰 你 没商量 我们 从 乌镇 到 西塘 临走时 坐 长途汽车 在 车站 安检 时 我们 带 的 半斤 原厂 包装 好 的 乌镇 买 的 三 白酒 死活 不让 带上 汽车 当时 报 了 警察 和 土匪 一样 无 规定 就是 不让 上车 简直 无法无天 景区 里面 更是 强买强卖 说实话 西塘 景色 比 乌镇 差远了 文艺 气息 更 远不如 鼓浪屿 交通 不 方便 只有 汽车站 还 像 土匪 窝 不 值得 去 不要 去 挨宰 饿死 西塘 人 吧	__label__1
坐船 做 坑 路过 另 一个 景区 还 得 买 另 一个 景区 的 门票	__label__2
我 对 丽江 的 印象 很 一般 当地 实在 是 太 商业 太 喧嚣 不是 我 的 菜 丽江 有 两个 古镇 一个 是 束河 古镇 一个 大研 古镇 束河 要 好些 人少些 水 也 相对 干净 些 丽江 真是 处处 都 是 坑 一不小心 就 多花 冤枉钱 了 所以 要 去 的 朋友 要 小心 啦 我们 幸好 遇到 一个 熟悉 当地 的 人 带 着 我们 逃 了 不少 的 票 省 了 不少 的 银子 嘿嘿	__label__2
江南 小镇 不 应该 收 门票 没有 什么 特别 的	__label__2
失望 的 海洋公园 之 行	__label__1
哦 人大 啊 是 的 那 不错 呦	__label__2
破旧 的 城墙 里面 在 装修 大门 紧闭 有 一种 危墙 的 感觉	__label__2
差评 差评 不满	__label__1
人多 设施 旧 品种 少	__label__2
因为 外教 要 我们 拍 一个 视频 才 去 的 离 学校 很近 里面 就 一个 昊天 塔 不能 进去 很 荒凉 有 一个 老 道士 一直 绕 着 塔 走 门票 还要 元 没什么 意思 完全 不 值得 去	__label__1
那么 小 没什么 好玩 的	__label__1
脏 一点 都 不好玩 还 笑 死 了	__label__1
就是 一个 极为 宰人 的 地方 门票 元人 包括 冰川 公园 、 蓝 月湖 、 云杉坪 、 牦牛 坪 啥 的 冰川 公园 、 云杉坪 、 牦牛 坪 都 只能 坐 索道 上去 冰川 公园 索道 费用 元人 云杉坪 索道 费用 元人 牦牛 坪 元 人 因为 景区 为了 赚钱 没有 修建 供 游客 自行 上山 的 栈道 极为 坑爹 景区 前买 氧气罐 分为 元 和 元 两种 好多 人 都 被 忽悠 着 买 了 但是 % 的 人 都 用不着 分钟 的 电瓶车 路程 要元人 分钟 的 电瓶车 路程 要元人 景区 大巴 会 把 游客 带到 一个 离 景区 较远 的 集散地 忽悠 游客 购买 电瓶车 票据 又 是 一 大坑 爹 进去 之后 必须 购买 元人 的 大巴车 票 因为 景区 比较 大 但是 路程 设计 极为 不 科学 需要 重复 回到 集散地 才能 到 下 一个 景点 浪费 了 好多 时间 根本 没 办法 充分 游玩	__label__2
国内 最坑 的 游乐场 所	__label__1
差差 差差 差差 差	__label__1
秦始皇陵 里面 一个 购物 的 地方 买 了 两个 镯子 一个 戴 在 手上 另 一个 让 她 给 我 包 起来 竟然 调货 在 皇陵 里面 干 这种 事 不怕 么 还 好看 了 一下 还要 送人 的 上面 刮痕 黑点 那么 多 气死 了 大家 注意 千万别 买	__label__1
葡萄沟 看看 葡萄 门票 感觉 被 坑 惨 了	__label__2
没有 书上 描绘 的 那么 壮观 只是 湖中 的 三处 小潭 而已	__label__2
地方 太小 了 门票 也 不 便宜 啊	__label__2
失望 失望 根本 不能 用 还 好意思 让 我 点评	__label__1
坑 无敌 坑 买 了 两趟 门票 进门 买 一份 然后 地理位置 不 清晰 进 到 里面 还要 单独 收费 看 废墟 [ 弱 ]	__label__1
强烈建议 考虑 有关 安全 问题 人 感觉 是 被 塞进 电梯 完全 是 一种 令人窒息 的 感觉 根本无法 看到 所谓 的 风景 绝对 不 推荐 去 坐 完全 是 一种 破坏 旅游 心情 的 体验 只 可远观 当为 景点 看看 还 可以	__label__1
就是 一个 消费 岛 没什么 东西 特产 、 娱乐 、 吃饭 、 小吃 相对 都 比较 贵 我 感觉 没什么 好玩 的 打发 时间 哈哈	__label__2
点评 有奖 第季 不好意思 我 在 这里 要 严重 吐槽 一下 三清山 了 景色 没 问题 一如既往 地好 很 仙 很 好看 但是 旅游 设施 和 服务 实在 是 太差 了 厕所 很差 厕所 很差 厕所 很差 重要 的 事情 说 三遍 第一 整个 景区 厕所 的 数量 很少 大概 才 个 很多 厕所 是 那种 不 分 男女 的 单间 的 移动	__label__2
正月 庙会 去 的 庙会 是 没意思 的 那 时间 公园 也 没 东西	__label__2
景区 管理 极其 混乱 游船 排期 极其 不合理 吵 骂声 不绝于耳 大家 纷纷表示 以后 不会 再 来 宜昌 旅游 我 听到 不止 五次 路 人 这样 评说 进 景区 排队 三个 小时 出 景区 排队 一个半 小时 中间 就 玩 了 两个 小时 要不是 举报 投诉 的 表格 太 繁琐 我 在 排队 过程 中 就要 在 国家旅游局 微信 上 进行 投诉 联系 拿掉 评理 进行 整改	__label__1
嘉峪关 有 一个 的 联票 是 三个 景点 第一 墩 悬臂 长城 和 关城 那么 问题 来 了 联票 就 联票 吧 三个 地方 之间 没有 景区 直通车 隔 了 几十公里 怎么 去 啊 还 得 自己 打车 去 车费 都 快 赶上 门票 了 而且 关城 只卖 联票 不卖 单独 的 票 这个 服务 做 得 很 差 很 差	__label__2
不是 很 好	__label__2
我们 一路 西行 十个 景点 中 二郎 剑 是 最 不值 的 什么 都 没有 清海湖 别处 照相 藏民 抓住 就 要钱 向 藏民 花线 前近 湖边 全是 垃圾 垃圾 差评	__label__1
从来不 写 评价 的 这次 忍不住 了 去 长城 选择 的 是 火车 北京北站 进去 刷 公交 卡到 八达岭 后出 站 也 要 刷 真是 运气 爆棚 了 在 车上 就 下雨 了 早上 第一趟 是 六点 多 没 赶上 坐 的 的 一趟 离开 车 还有 好长 好长时间 进站 口 已经 很多很多 人 了 进站 真的 是 百米 冲刺 抢 座位 搞不懂 为什么 不多 弄 几节 火车 差不多 一个 小时 二十分钟 就 到 了 火车 里 跟 高铁 差不多 不过 就 四节 到 站 后 又 提 的 干粮 和 水 又 下 暴雨 真是 倒霉 有 雨衣 卖 五块 一个 山 底下 有 免费 接驳 车 建议 准备 徒步 爬 长城 的 不要 坐 这个 车 就 直接 把 你 拉 到 坐 缆车 的 地方 下车 后 的 售票点 只有 买 缆车 才給 你 卖 长城 门票 走 到 徒步 爬 长城 的 地方 还 很 远 很 远走 的 北线 因为 大雨 就 爬 了 两个 烽火台 第二个 烽火台 的 坡 已经 非常 之 陡 了 并且 我 的 鞋 也 坏 了 去 火车站 的 那条 街有领 好汉 证 的 地方 进去 照相 他会 先給 你 介绍 有 照片 的 证书 的 你 可以 不要 拿 一个 证书 去 一楼 有 照片 就是 比较 小拿上 可以 盖个 钢印 免费 还 可以 免费 打印 两张 手机 里 的 照片 八达岭 火车站 很小 依旧 坐 一点 四十 的 火车 离开 还有 很 长时间 已经 有 很多 人 排队 了 站 里 有 卖 火车票 的 可以 随时 坐 其中 一趟 最迟 发 往 北京 北 的 是 晚上 九点 爬 长城 其实 就是 爬山 真的 是 不到长城非好汉 到 了 长城 好 遗憾 不 建议 小孩 和 老人 去 穿 防滑 鞋	__label__1
爬 金顶 路过 的 一个 地方 没什么 好看 的	__label__2
荻港 有 一种 复古 味 比较 安静 适合 休闲活动	__label__2
我 最 不 满意 的 就是 这里 明明 可以 网上 买票 我 买 了 去 了 刷 身份证 说 机器 坏 了 要 我 退票 去 售票口 买票 三十块 一张 我 心想 机器 坏 了 没有 办法 我 就 去 买票 了 最后 退票 商家 系统 拒绝 退票 找 了 客服 结果 两张 退 了 一张 说 我 消费 了 一张 我 两个 人带 着 孩子 去 的 我 消费 一张 另外 一个 人 咋 进去	__label__1
单位 旅游 不 推荐 没什么 好看 的 点	__label__2
天 啦 这个 水磨 古镇 也 能 叫 景区 现代化 太 严重 还 修 了 游客 中心 不 知道 有 什么 旅游 价值 的 就是 个 农村 小镇 看不出 有 好 古老 有 羌 城全 是 酒吧 没 啥 耍 头 失望 停车费 元人 都 没 几个	__label__1
特地 为了 看 猴子 但是 结果 不太 美好 那些 猴子 好凶 还会 抢 游客 的 东西 还有 一个 游客 好像 是 被 猴子 抓伤 了 要 看 猴子 的话 慎重 吧	__label__2
价格 有点 贵 没 啥 可以 玩 的 地方 也 不是 很大	__label__2
荒凉 的 景点	__label__2
看 了 跑 男 专门 跑 去 好 失望 就是 一片 芦苇 地 月底 去 的 全是 枯枝 坐 了 一段 船下 陆地 也 没 发现 特色 景点 落魄 了	__label__1
去 铜铃 山 森林公园 路过 顺道去 看 了 看用 的 是 年 卡 一家 三口 仅仅 花元 的 接送 票 女儿 不到 米 都 要求 买 但 还是 觉得 不 值得 总体 感觉 这 就是 最 坑人 的 景点 没有 之一 景区 内 没有 任何 特色 而且 还 在 修建 中 如果 你 想 看 猴子 还是 去 动物园 爬山 就 去 大 罗山 吧	__label__1
有山有水 还 有些 农村 气吸 商业 还 不重	__label__2
失望 的 一次 体验	__label__2
烂 太烂 了 不好玩 也 没什么 可以 看 的	__label__1
这种 地方 说实话 您 真别 来 各种 醉汉 挤 的 要死 就是 看人	__label__1
进去 了 一趟 终于 知道 为什么 我 认识 的 武汉 人 都 说 从来 没 去过 黄鹤楼	__label__2
感觉 最该 受教 的 却是 孔子 脚下 人 儒家 学说 被 外 人学 用 圣地 人 却 相当 野蛮 缺德 从 的士 三轮车夫 到 导游 和 当地 摆地摊 的 生意人 唯利 是 徒	__label__1
不 清楚 门票 这么 贵 里面 很多 活动 还要 收费 环境 差 设施 差人少 估计 再 半年 快 关门 了	__label__1
当时 是 跟 团去 看 的 去 到 三叠 泉 所在地 要 经过 一个 石阶 去 时 是 下 回来 时 是 上 还 有点 远 至于 风景 只能 说 普普通通 个人 觉得 没什么 看点	__label__2
号 受 台风 影响 大雨 没有 去 成	__label__1
七月 三十日 成都 出发 自驾游 青海湖 组团 咯 男女 不 限 现有 一男一女 小型 一辆 愿意 分摊 费用 的 联系 我 一下	__label__1
影响 心情	__label__1
失望 之旅	__label__2
千里迢迢 来 的 真的 没意思 可能 不是 搞 艺术 的 人	__label__2
坑爹 的 景点 此生 不会 再 去 当 你 走进 大门 后 就 有种 被 骗 的 感觉	__label__1
来 不来 百草园 已经 不是 因为 他 值不值得 看 而是 圆 了 小时候 的 好奇心 毕竟 他 只是 一小片 菜园子	__label__2
北京 市郊 旅游 的 地方 说实话 真的 没什么 意思 春天 月底 去 的 寺里 玉兰花 已开 零星 有 樱花 但是 山 还是 光秃秃 的 没有 什么 神秘 和 幽静 的 感觉 爬 爬山 还 可以	__label__2
不 值得 去 没 啥 好 的	__label__1
携程 订票 过去 后 告诉 我 未 开放 携程 上 写 着 开放 景点 不 开放 这算 啥 欺骗 过去 后 不要 油钱 浪费时间	__label__1
是 一个 人造 岛 很大 如果 游览 就 必须 做 观光车 其实 风景 很 好 但 觉得 政府 花 这么 多钱 去造 景观 带动 旅游业 很 不 值得	__label__2
不怎么 地	__label__2
武夷 宫 保养 得 不太好 感觉 还 不如 朱熹 园 分钟 走 完	__label__2
被 坑 了 网上 买 了 夜票 到 了 售票点 说 座位 满 了 网上 订 的 走 不了 了 让 和 网上 联系 结果 到 现在 也 没有 确切 的 联系电话 短信 上 的 电话 根本 打 不通 一 打通 就 自动 挂掉 了 建议 网上 提前 买 或 到 售票点 提前 买票 要 不 很 扫兴 的	__label__1
无 意义	__label__2
没有 亚 热带雨林 的 感觉	__label__2
一个 字 坑 两个 字 尼玛 太坑 了 人 多 我 就 不 说 了 因为 已经 做好 人多 的 准备 了 不能 停留时间 长去 拍照 因为 后面 队伍 就 走不动 了 本来 以为 很 惊险刺激 的 栈道 谁 知道 走上 去 根本 没 感觉 我 不是 说 我 胆子 大 就 连 我 老婆 这样 胆子 很小 的 人 也 说 没什么 感觉 虽然 要求 大家 都 穿鞋 套 但是 玻璃 几乎 都 刮花 了 朝底 看 去模糊 一片 本来 想 多 拍 几张 照片 的 但是 实在 觉得 根本 没 啥 拍头 天门山 很坑 名不副实 多 块钱 真的 不值	__label__1
听说 有时候 会 有 庙会 之类 会 免费 的 我 花 了 人均 的 门票 进去 看 石刻 可想而知 我心 多痛 可能 年幼无知 也 不曾 了解 过 更 没有 请 景区 导游 讲解 历史渊源 所以 整体 观光 我 觉得 很 无聊 比 到此一游 还 无聊 当时 去 的 时候 里面 的 貌似 是 寺庙 吧 在 重新 整改 不能 进去 这是 最大 的 遗憾 我 觉得 去 的 人 呢 一定 要 了解 下 它 的 历史 北京 或 请 导游 讲解 才 会 有 印象 些	__label__2
有点 坑 啊 去 的 时候 是 八月 初 太阳 非常 猛 沙滩 上 的 巨型 沙雕 还 在 制作 中 只能 看到 一层层 的 木 架子 只有 小树林 里 的 童话 沙雕 勉强 能 看看 就 这点 沙雕 收 的 门票 实在 是 有点 过分 要 知道 很多 地方 的 沙滩 都 是 免费 的 沙滩 属于 全 中国 人民 我 觉得 任何人 无权 收费 沙雕 因为 花 了 人力物力 所以 收 点 费用 是 应该 的 但是 沙雕 还 没 弄 好 你 却 收 全价 这个 说不过去 吧	__label__1
国家 五 风景区 庐山 我 是 领教 了 游客 的 我 在 景区 里 小孩 意外 受伤 血流 满地 我 第一 时间 打 了 却 被 告知 我要 打 另外 的 电话 后来 才 知道 这里 有 其它 省份 的 信号 我 只好 拿出 花元 买 的 门票 来 求助 打 了 里面 提供 的 咨询电话 竟然 叫 我 打 我 说 我 打过 了 没有 效果 我 现在 要求 你们 景区 提供 帮助 一个 游客 在 景区 里 意外 受伤 除了 第一 时间 自救 之外 肯定 想 尽快 得到 有效 的 帮助 的 而且 也 不 知道 离 出口 有多远 可 电话 那头 告诉 我 的 是 这事要 打不关 他们 事 试问 游客 花钱 进 景区 景区 收 了 门票 就 什么 都 不关 他们 事 吗 还是 国家 五级 景区 呢 不过 在 这里 我要 感谢 游客 中 的 老外 、 还有 带帽 的 小伙子 还有 一帮 忘 了 是 什么 中医 大学 游客 的 帮助	__label__1
因为 去过 黄山 知道 黄山 的 风景 是 非常 美的 但是 天公不作美 此次 一家老小 同 去 山上 却 一直 在 下雨 在 云雨 中 能见度 一两米 什么 风景 都 看不到 一片 白茫茫 越往 上风 越 大雨 越大 所有 的 人 都 在 匆匆 而 过 急于 寻找 下山 最近 的 路	__label__2
到 爆炸 没有 溧阳 御水 温泉 的 十分之一 好玩 、 干净 一共 只有 几个 池子 而且 很小 但是 里面 食堂 的 面条 不错 好吃	__label__1
服务 真心 差	__label__2
真 心想 不 明白 为什么 这 是 个 五星 景点 景色 一般般 收费 还贵 路线 规划 和 路标 不 清晰 搞 得 游人 一头雾水 首先 可能 是 船 比较 大 所以 船次 较 少 错过 一班 要 等 半小时 真的 是 很 浪费时间 船期 也 没有 标明 没 人 知道 什么 时候 来船 如果 有 船期 大家 还 可以 根据 时间 来 规划 每个 点玩 的 时间 第二 路标 指示 不 明确 第二个 景点 巴王 寨 下船 的 时候 可以 选择 坐 扶梯 也 可以 步行 问题 是 路牌 全部 指向 扶梯 一边 然而 步行 是 反 方向 的 走 了 不少 冤枉路 而且 下船 之后 是 往回 走 的 就是说 巴王 寨 在 第一个 下船 点 ( 第一个 景点 ) 与 第二个 下船 点 之间 从 第一个 景点 走 去 巴王 寨 顺路 但是 从 第一个 景点 坐船去 第二个 景点 ( 巴王 寨 ) 还 得 往回 走 分钟 游玩 后 原路 返回 第三 作为 一个 五星级 景点 游船 上 的 音频 介绍 非常少 起码 说 清楚 游览 路线 吧 介绍 多点 历史 文化 不要 只 懂 通知 下船 时 小心 此外 还 需要 注意 不是 每个 码头 都 是 可以 坐船 的 里面 还 混杂着 两坝 一峡 的 游船 所以 要 看清楚 是 景区 游船 还是 联合 游览 的 船 总之 不 推荐 有钱 没 地方 花 的 可以 去	__label__2
一个 门 历史 政治 象征意义 本身 无 美感	__label__2
没 赶上 时间 居然 不能 退票 明显 属于 强制 消费 都 年 了 还是 一付 计划经济 时代 的 朝南 坐 的 强调 不 说 了 自认倒霉	__label__1
非常 差 非常 不 满意 上天 终于 惩罚 这群 贪婪 的 九寨沟 管理者 门票 非常 贵 虽然 讲 可以 分次入 但 又 规定 买票 当天 要 确认 第二天 门票 等于 要 客人 排次队 简直 是 混帐 管理	__label__1
千岛湖 除了 山水 不要 你 钱 别的 都 是 黑 的 朋友 们 小心 上当 我 劝 朋友 们 换个 地方 去	__label__1
看 红叶 的 季节 或许 可以 去 一下 适合 爬 爬山 风景 一般般	__label__2
爬山 看江 里面 有 对 台州 的 历史 介绍	__label__2
我 特地 注册 号码 来 评论 差评 我会 骗 你 进去 里面 就 几个 雪 雕塑 一个 电动车 拉 你 过去 就 一人 门票 还 贵得 要死 这么 多年 来 最 坑人 的 项目 坑得 我 对 整个 哈尔滨 都 失去 了 兴趣	__label__1
太差 了	__label__1
一 开始 就是 冲着 过山车 去 的 到 了 居然 不能 玩 还有 很多 设施 都 不能 玩 差评 游乐 项目 太 少 不值 这个 价格	__label__1
非常 悲 催 的 一次 经验	__label__1
说真的 作为 一个 散步 的 地方 我 给 一百分 但是 作为 一个 旅游 景区 我 想 还是 不够 的	__label__2
人太多 啦 反正 来 了 南京 就 顺便去 下咯 随便 逛逛 打发 时间	__label__2
景区 不 大 风景 非常 一般 门票 元 景区 提供 免费 导游 到 各 小 景区 需 排队 贡院 景区 参加 游戏 考试 时 只 需要 写 名字 如果 你 字 很漂亮 还 能 让 人 认出 那 恭喜 你 你 中 状元 了 你 会 比 别的 游客 多花 一些 银子 买点 你 可能 不 喜欢 的 东西	__label__2
太 差	__label__1
讲真 这 就是 两座 亭子 啊 而且 是 后来 造 的 大家 就 不要 浪费 钱 啦 爬上爬下 多累 啊 省点 体力 看 别的 啊 当然 如果 特别 喜欢 历史 的 人 可以 去 看看 人文 情怀 嘛 同行 的 小伙伴 有 上去 人不多 外景 在 车上 就 可以 看到 山上 风 比较 大 注意 保暖	__label__2
如果 去过 西栅 了 建议 就 别来 这里 了 这里 根本 既 没有 风景 也 没有 人文 只有 见钱眼开 的 商家 超级 不 推荐 这里 就 不要 浪费 门票 钱 了	__label__2
真 不是 吹牛 逼 通州 一代 除了 农方荣兴 庄园 建设 的 最 完善 费用 又 低 以外 就是 不能 住宿 我敢 说 没有 比农方 荣兴 在 牛 逼 的 了 摩登 我 也 去过 没什么 意思 烧烤 还单 收费 人家 农方荣兴 就 一 门票 全包 多 说 无意 只有 真正 体验 过去 过 一次 才 知道 你 就 知道 通州 一代 哪个 家庭 庄园 牛 逼 了	__label__1
八达岭长城 言过其实 不 值得 去 除了 看人 确实 看不到 什么 想 看 的 又 累 又 闹心	__label__2
位于 溪口 雪窦山 国家级 风景 名胜区 紧靠 蒋母 墓道 旁边 植有 三万多 株 名贵 杜鹃 当 山花 烂漫 时 杜鹃 吐红 相嵌 青山 之中 甚 是 漂亮 可惜 的 是 那个 滑 草场 已 关闭 少 了 一个 好玩 的 景点	__label__2
我 是 觉得 可以 不 用来 了 价格 对不起 风景	__label__1
‘ 不须 此行	__label__1
蒽 挺好玩 的 有 很多 动物 可以 看 特别 可爱 真的 ! 就是 天气 太热 而且 里面 都 是 要 另外 算钱 的 一瓶 水 就要 元	__label__2
居然 是 景区 老江 提名 难怪 这么 坑 一个 大 水塘 加烂 沙滩 沙 没有 鸣沙山 的 线条 美感 水 也 不美 浑浊 无感 承包 出去 一堆 娱乐 项目 门票 船票 总之 就是 一个 很 坑 的 景点	__label__1
不值 \ '	__label__1
没有 预想 好 景点 比较 单调 徒有虚名	__label__2
很烂 了 只有 演出 没 必要 去 的 啦	__label__2
我用 都 没有 用 就 自动 收费 了 怎么 这样 的 啊 完全 是 骗子 骗子 我要 举报 你们	__label__1
地方 是 好 地方 可惜 骗子 太 多 尤其 是 那里 的 和田玉 什么 抽奖 活动 什么 的 骗子 很多 专门 骗 外地人 也 没人管 去 那 要 多 张个 心眼	__label__1
人 超级 多 排队 都 排 小时	__label__2
基本 情况 应该 是 废弃 的 电站 大坝 了 看来 很久没 有 泄洪 了 交通 情况 乘坐 景区 观光车 元 七天 前往 或 出租 前往 或 包车 或 步行 需要 提前 查好 里程 心里 有 个数 如果 要 前往 石门 涧 瀑布 可以 从 这里 乘坐 星龙 索道 前往 电站 大坝 只能 说 一般 吧 不 推荐 没 啥 景色 旁边 的 芦林湖 很 美	__label__2
内容 非常 无聊 东西 还 挺 贵 如果 你 是 从来 没见 过 热带丛林 勉强 可以 如果 看过 千万别 来 千万别 来 千万别 来 那个 梦幻 丛林 的 块钱 就是 糊弄 乡下人 的	__label__2
泰山 名气 大 景色 实际 名不副实 比较 失望	__label__1
对 桂林 佳音 导游 印象 不好 不 正规	__label__2
也 是 一个 名副其实 的 地方 环境 十分 优美 就是 想不出 什么 合适 的 词语 来 形容	__label__2
不 值得一看 的 景区	__label__1
房主 逃到 了 台湾 里面 有些 房子 租给 了 卖 字画 的	__label__2
是 收 门票 的 地方 月底 去 的 比较 没意思	__label__2
我们 在 火车站 坐游 去 的 很 方便 火车站 有 很多 车 都 喊 到 兵马俑 但游 是 国营 的 环境 好 售票员 介绍 了 很多 非常 流利 很 清楚 先到 华 清宫 没什么 玩 的 都 是 后人 盖 的 我 觉得 特别 没意思 而且 下车 的 人 也 不 多 门票 还 很 贵 里面 有 兵谏亭 还好 吧 没 戴 多长时间 就 去 兵马俑 了	__label__2
不 明白 为什么 会 有 这个 地方 的 添加	__label__2
江南水乡 的 景色 都 一样 白墙 黑顶 红 西塘 的 交通 实在 不 方便 从 无锡 去 的 时候 打 顺风 车人到 西塘 景区 外 停车场 保安 就 气势汹汹 的 让 买票 不让 进打 了 酒店 电话 给 门口 发了 传真 才 放人 进门 保安 态度 极差 我 对 西塘 的 期待 一扫而光 门票 一个 人 如果 不进 那些 景点 内 的 小 景点 完全 不用 买 西塘 里 老街 小巷 全部 小商 小店 旅游 产品 买 了 当地 的 黄酒 和 芡实 糕 小本生意 不好 做 一家 卖 臭豆腐 的 态度 很差 感觉 不 付钱 一样 从 西塘 去 杭州 可 到 嘉善 站 到 杭州 站 如果 没有 就 坐 嘉善 南到 杭州 东从 西塘 到 嘉善 南打 出租车 挺 好 费用 大概 总体 感觉 费时费力 来 这 一趟 不是 很 划算 [ 汗 ] [ 汗 ]	__label__2
就 一个 破 马车 一看 就是 骗钱 的	__label__1
非常 差 在 景区 门口 刷不出 身份证 卖家 不 找 自身 的 问题 还 说 我们 当时 留 的 电话号码 必须 一人 一个 号 退票 卖家 说 稍 等 就 能 解决 等 卖家 和 美团 解决 了 我们 在 景区 门口 等 了 两个 半小时	__label__1
这家 农家乐 太 黑心 朋友 们 千万 不要 来 老子 就是 窝 尿 都 不朝 这方 [ 生气 ] [ 生气 ] [ 生气 ] [ 生气 ]	__label__1
从 茅坪 景区 去 象山 庵 的 途中 会 经过 景区 的 大巴 司机 不会 在 这里 停留 所以 只能 远观	__label__2
应该 怎么 说 呢 我 第一次 对 一个 城市 吐槽 不停 第一次 给 两星 我 也 是 吉林 人 但是 我 必须 说实话 首先 展馆 是 分 时段 开放 的 你 要 在 下 一批 人 访问团 参观 前 分钟 排队 领票 但 恐怕 排队 没有 用 这 是 第一 坑 第二 坑 凭 身份证 领票 切记 必须 用 身份证 他们 只认 这 一证 第三 坑 两层 的 国家 二级 博物馆 建设 很 好 但是 只用 分钟 就 给 你 带 出来 解放军 姐姐 的 讲解 还 可以 但是 太快 了 然后 就是 你 的 访问 过程 全程 有 一些 人 监视 着 总之 这座 纪念馆 让 人 感觉 很 奇葩 无力 吐槽 如果 真的 对 这段 历史 有 兴趣 就 去 访问 吧 关注 历史 的 人 不会 特别 在乎 这些 但是 如果 没有 啥 兴趣 在 英雄 广场 上 逛逛 也 是 不错 的	__label__2
香火 很旺人 很多 寺庙 不 大 名气 大 个人 觉得 不如 山上 的 另 一 寺庙	__label__2
这个 景点 离 旅游 车站 点太远 了 如果 有 老人 和 孩子 的 一定 要 做好 准备 个人感觉 不如 桃源洞	__label__2
如果 不是 看 演出 千万别 去 华清池 可惜 了 票价 破 的 不能 再破	__label__2
门票 真贵 再次 产生 了 中国 玩不起 的 感觉 从 南锣鼓巷 走 过去 本来 想 感受 周围 建筑风格 的 变化 没想到 真的 没太多 特色	__label__2
去 北京 天 基本 把 北京城 逛 了 个 遍 觉得 最 没意思 最 冷静 的 地方 就是 这个 艺术 区 真的 变 了 个 味 或许 只是 我 没有 艺术细胞 没有 下次	__label__2
太小	__label__2
由于 是 跟 团去 的 旅行社 统一 订 的 票 而且 正好 赶上 第一天 试运营 大排长龙 的 场景 可想而知 同行 带 单反 的 都 被 拒之门外 还好 是 跟 团暂 存在 导游 那儿 了 进去 后 还要 换鞋 套 走过 桥后 还要 回收 的 换上 鞋套 后 排队 验票 上桥 上桥 后 就 感觉 深深地 被 坑 了 并 不是 传说 中 全透明 的 玻璃 桥面 而是 间隔 一块块 的 透明 玻璃 玻璃 表面 已经 有 很多 磨痕 了 所以 桥下 的 风景 并 不是 清晰可见 的 在 桥 上 拍 了 点 照片 就 下桥 了 一点 都 不 刺激 失望 至极 这样 的 体验 一次 都 嫌多 去过 你 就 造	__label__1
去过 这么 多 城市 的 博物馆 义乌 博物馆 是 最差 最 没 东西 的 一个 博物馆 没有 之一 只有 两个 展厅 楼下 一个 楼上 一个 楼下 的 那个 是 陶器 展 楼上 那个 是 什么 都 已经 忘记 了 就 三个 工作人员 + 厕所 我 下来 一问 没 啦 答 曰 没 了 问 还有 没有 另外 一个 新馆 答 曰 没 楼下 楼梯 下 还有 个 名人 展 就是 放 了 些 照片 和 生平 简直 就是 上 世纪 年代 的 文化馆 一样 我 都 觉得 自己 穿越 了	__label__1
对于 这里 呢 我 真的 不想 说太多 了 有 什么 可看 的 不 明白 了 安检 严格 的 不行 人 也 多 的 不行 早上 要是 想 看 升旗 找个 好 位置 凌晨 点到 都 不 一定 能 找到 合适 的 位置 逢年过节 的 人 多 的 不行 人 挨 人人 挤人 的 什么 都 看 不了 周边 只能 做 地铁 或是 公交车 打车 根本 不停 你 得 走出 两公里 才行 反正 真的 没什么 可看 的 没有 可玩 的 没什么 景色 可 拍 的 要是 时间 挺紧 的 最好 让 司机 走 长安街 路过 看 一眼 就 好 了 别 特意 来 了 浪费时间 还 不如 去 别的 景点 多 玩玩 呢	__label__2
庐山 瀑布群 在 庐山 大峡谷 里 从 东林寺 西林寺 上山 的 又 一条 路	__label__2
最 糟糕 的 一次 旅行	__label__1
专门 卖 葡萄干 的 地方 我 觉得 可以 不去	__label__2
门票 很贵 太高 消费 了 停车 要 五十 的 停车费	__label__1
水 已经 干枯 什么 都 没有 千万别 去	__label__1
怕人 多 的 千万别 去 第二次 去 更 后悔 了	__label__2
都 是 拆 老 建新 没什么 意思 还 不如 东门 老 也 就 夫子庙 能 进去 看一看	__label__2
服务设施 太乱 景区 人山人海 售票 窗口 只要 一个 太 不 人性化 一定 要 改进	__label__2
真心 坑 一天 只 玩 了 五个 项目	__label__2
一个 普通 的 建筑群 竟然 能 成为 景点 实在 令人 脑洞 大开	__label__2
酒吧街 很 出名 但是 很 拥挤	__label__2
无人 管理 的 风景点	__label__2
里面 的 食品 绝对 不能 吃	__label__2
这 也 配五 八点 到 旅游 车站 被 告诉 就 一趟 九点 二十 出发 傻 等 一个 小时 旅游车 不单 卖 车票 强迫 购买 门票 才 让 你 坐车 严重 鄙视 驴 妈妈 和 北门 旅游 汽车 车站 到 了 地方 以后 看 一个 古人类 博物馆 比 周口店 差太多 里面 各种 收费 项目 不 骑骆驼 你 就 走 半小时 中午 只能 在 景区 吃饭 一碗 面等 半个 小时 啥 也 没有 下午 因为 人少 就 一辆车 三点 回去 想 早 走 晚 走 都 不 可能 就 这么 差 的 交通 条件 怎么 能 评五太 垃圾	__label__1
就是 几个 坑 特别 坑 千万别 去 也 不用 请 讲解	__label__2
太 一般 迪士尼	__label__2
好好 奋斗 哈哈 有太多 妥妥 的 人	__label__1
乌镇 文昌阁 位于 乌镇 东栅 景区 内	__label__2
你 关注 昌平 乐多港 奇幻 乐园 今年 暑期 开业 满足 你 所有	__label__1
景区 管理 极其 混乱 游船 排期 极其 不合理 大家 纷纷表示 不会 再 来 宜昌 旅游 我 在 路上 听到 不止 五个 路 人 这样 评说 进 景区 排队 花 了 三个 小时 出 景区 花 了 一个半 小时 都 是 无序 的 挤来挤去 的 不 插队 根本 进不去 插队 的 人 心安理得 没 人 管理 建议 拿掉 的 牌子 进行 整改	__label__1
后 海 湖面 辽阔 景色 迷人 适合 跑步	__label__2
一句 话 花钱 找罪 受 相信 我 没有 去过 的 朋友 们 就 别 去 啦 不如 到 舟山 找个 岛 好玩	__label__1
看到 这个 还有 个 老太婆 和 一个 瘸子 对 着 路上 照相 的 游客 骂街 说树 是 他们 家 的 照 一张 像 要 元 摸 一下 元 不然 谁 都 不许 照 我 就 真 不想 去 了	__label__1
并 不 推荐 尝 了 这里 的 老 酸奶 真的 不 好吃 没什么 好 逛 的 这里 特产 也 不 推荐 不 好吃	__label__1
景区 太小 城墙 太矮 环境 太脏 没 特色	__label__1
我 觉得 这里 就是 一个 坑 如果 特意 去 桃花源 的 我 奉劝 各位 不要 去 但是 龚滩 古镇 是 值得 一去 的 由于 要 去 龚滩 古镇 因此 没有 去 旁边 的 酉 州 古镇 里面 的 伏羲 洞 当时 没有 时间 了 也 就 没 去 了 我 觉得 每个 洞 都 差不多 因为 自己 在 初中 就常去 一些 山洞 探险 因此 认为 桃花源 里面 真 没 啥 特色 幸好 是 买 的 学生票 要不然 的 门票 真 有点 坑	__label__2
无 性价比	__label__2
蓟县	__label__1
动物 少 适合 小孩子 玩	__label__2
加大 版 的 宽窄 巷子 但是 除了 卖 牛肉 卖 醋 的 卖 川北 凉粉 的 就 没有 任何 特色 了	__label__2
动物 不错 但 停车 实在 太 恶心	__label__2
好 无聊 啊 游乐 设施 老旧 风景 也 没什么 好看 的	__label__2
不 推荐 就是 有个 老虎滩 公园 但是 从 老虎滩 出发 沿着 滨海 路 一直 走北 大桥 的 风景 不错	__label__2
西单 是 北京市 西城区 的 一个 以 商业 为主 的 街区 西单 得名 于 老 北京城 俗称 的 西单 牌楼	__label__2
买错 了	__label__1
不会 去 第二次	__label__2
里面 什么 都 没有 在 级 台阶 之后 就 只有 一个 有着 孙中山 先生 雕像 的 陵墓	__label__1
这个 不能 算是 一个 景点 就 像是 走 在 路上 地图 上 标注 这里 有 一个 容易 辨别 的 特征 物 一样 或者说 就是 路上 的 一把 椅子 只是 一个 指引方向 的 地标 全 当 路过	__label__2
六一 儿童节 快乐	__label__2
演出 很棒 到 是 对 服务 提差评 打电话 问 老人 是否 有 优惠 回答 没有 优惠 与 实际 购票 选择 不 一致 后期 因为 对 演出 地点 不 清楚 打电话 询问 刚 开始 还有 人 接电话 到 后来 就 没有 人 接电话 了	__label__1
映像 太阳岛	__label__1
园子 挺大 但 就 一个 公园 而已 没 特色 花 也 死 的 差不多 了 门票 死贵	__label__2
同 苏小小 墓 一样 没 必要 重建 不过 路过 时 凑 过去 一看 还 有些 惊讶 没想到 传说 中 的 武松 葬 在 这里 啊	__label__2
西安 去 华山 千万 不要 坐 汽车 太特 么 坑 了 等 了 一个多 小时 都 不 发车 还 不如 坐火车 工作人员 的 回复 老是 敷衍 人	__label__1
是 一个 一上 岛 就让 我 无比 蛋痛 的 地方 点评 一下 一个 只要 分钟 就 能 到 但 偏偏 要 游客 花 多元 且 浪费 分钟 去 的 一个 地方 岛上 看不到 任何 自然 景点 所谓 的 景点 还要 另 买 门票 岛上 的 所有 店面 都 和 中山路 、 曾厝安 没有 什么 区别 都 是 卖 一样 的 东西 硬 要说 区别 就是 卖 的 更贵 更贵 更贵 个人 总结 一下 没事 就 别去了 这 就是 一个 去不去 都 让 人 后悔 一辈子 的 地方 叫 我 就 别去了 反正 都 是 后悔 不去 还 能 省 下 不少 钱 我 下岛 后 有 一 想法 不 知道 对 不 对 说 鼓浪屿 好玩 给 那么 高 评价 的 人 是不是 有 很多 一些 人 是 报 着 不能 就 自己 上当 的 心情 写 的 反正 不能 就 我 一人 上 档 大家 都 上当 了 自己 才 不 亏 呀	__label__1
就 我 个人感觉 而言 如果 不是 江泽民 的 祖籍 地 这里 可能 评不上 景区 实在 太 一般 了 很 失望	__label__1
社会 在 发展 人类 在 进步 他 的 意义 还 在 但是 风光 确实 不如 从前 了	__label__2
坐车 总会 路过 的 没什么 可看 的	__label__1
冬天 是 她们 最美 的 地方 但是 要 想 看见 雾凇 也 是 需要 运气 的	__label__1
最近 在 装修 了 希望 装修 好 以后 硬件 可以 升级 一下 开 了 那么 多年 里面 的 东西 坏 的 好多 小朋友 去 了 好 失望 的	__label__2
不 推荐 去 很大 一部分 都 是 后来 建造 的 而且 特别 商业化 刚 进去 我们 是 坐船 游览 的 从 划船 的 师傅 那里 得知 其实 是 仿 乌镇 建造 的 门票 一个 人 坐船 的话 全程 元 每人 半程 元 每人 全程 大概 分钟 给 人 整体 的 感觉 景色 并 没有 实实在在 的 水镇感 毕竟 是 仿 的 嘛 感觉 没有 什么 意思 、 步行 回来 经过 的 街 都 是 卖东西 的 、 然而 并 没有 什么 特色 也 并 不 好吃 想 吃 的话 还 不如 去 南锣鼓巷 整体 感觉 建筑 比较 浮躁 没有 水乡 古镇 的 温润 沉淀 之感 环卫 人员 也 没有 好好 打扫 很多 游客 在 吃 东西 环卫 人员 用 扫把 一直 在 扫 然而 并 没有 什么 东西 只是 瓶盖 扫 的 全是 灰尘 也 是 醉 了 明明 是 游客 休息 的 座椅 硬要 捡 垃圾 还 零落 的 洒 在 座椅 上 扬长而去	__label__2
一般 一般 如果 不进 灵隐寺 不 推荐	__label__2
景色 还 可以 就是 人太多 了 而且 奔 着 红叶 去 的 结果 完全 木有 红叶 啊	__label__2
买 的 票 是 红门 爬 上山 的 一路上 景点 不 多 环境 脏乱差 服务设施 根本 没有 山民 开 的 小店 非常 多 毫无 淳朴 可言 不 值得 去 最后 建议 爱 干净 的 女性 自备 成人 尿袋 某宝 有 卖 吸水 成 固体 题外话 天朝 已然 没有 淳朴 的 景区 人民	__label__2
不 推荐 去 哦 绝对 是 又 一个 没去 会 后悔 去 了 更 后悔 的 景点 ╮ ( ╯ ▽ ╰ ) ╭	__label__2
和 公园 玩 没 啥 差别 其他 好玩 的 应该 要排 三四个 小时 一天 又 能 玩 几个 项目 呢	__label__2
恩施 卡斯特 地貌 和 重庆 当地 的 金刀 峡 武隆 黑 山谷 大同小异 无非 是 栈道 、 河谷 、 山路 重庆 的 朋友 要 降低 期望值 一天 徒步 游完 地缝 和 七星 寨 要 相当 好 的 体力 七星 寨 约 公里 很 费力 可以 考虑 坐 缆车 终末 有 扶梯 下山 没 必要 路程 很 短 尽量 减负 上山 路上 补给 很多 但 价钱 也 相应 贵些 但 总比 背上 很多 食物 爬 怎么 多 台阶 要 好 附近 很多 农家乐 一个 老板 说 有家 都 比较 大 网上 只能 搜到 的 很少 一部分 没太大 必要 在 网上 预订 到 了 景区 附近 有 很多 我国 庆 黄金周 去 的 都 没 注满 特别 注意 网上 有 一家 叫 许府 * 园 老板 态度 特差 简直 要 打人 驴友 要 注意 坐 班车 从 恩施 有 定点 车 晚上 约点 末班车 但是 从 利川 车 就 不 多 了	__label__2
很 普通 的 书院 就 在 岳麓山 上 不 推荐 进去 看 外景 即可	__label__2
年 夏天 去 的 一点 水 都 没有 开 了 四个 小时 的 车 逛 了 二十分钟 就 出来 了 !	__label__1
很 幸运 的 看到 了 长白山天池 因为 大雾 据说 去 长白山 % 的 人 都 看不见	__label__1
不怎么样 吧 这 只是 个人感觉 恩	__label__2
这个 时候 了 机票 还 不 打折 还 在 等 什么 朋友 们 你 懂 的 一方有难 八方支援	__label__1
中国 北京 唯美 可 加 无法 语言文字 形容 他 的 美绝 北京植物园 更是 如山 如画 到此一游 永不 后悔 遗憾 [ 微笑 ] [ 微笑 ]	__label__1
游人 如麻 到处 是 商铺 道观 算命 骗钱 没有 什么 东西 好看 的 不 推荐	__label__2
當地 人 說 千萬別 上去 但 還是 上去 了 虧 了 其實 看看 外景 就 好 了	__label__2
比较 后悔 就是 一个 大 浴室 没 啥 看头 只有 那个 舞台剧 还 有点 意思	__label__2
取票 不 方便	__label__2
没 啥 去 的 不 喜欢 玩 娱乐 项目 就 一个 类似 古镇 的 地方 千古 情 看看 也 一般	__label__2
不 推荐 的 原因 是 很 危险 类似 悬崖 还 没有 护栏 本身 就 已经 封道 了 所处 地区 在 天子山 较 偏 的 地方 人 很少 那 地方 很 安静	__label__2
青城山 为 道教 胜地 具说 是 全真教 道场	__label__2
来过 再也 不想 再 来	__label__1
没什么 可看 的 建议 不用 去 了 去 就 在 门口 照个 照片 好 了	__label__2
已 申请 退票 怎么 不 给 退 那 地方 有 机器 没 人工 的 移动 互联网 信号 都 没有 票 扫码 都 扫 不了 又 没带 身份证	__label__1
空白	__label__1
这 地方 一点 都 不好 五 景点 不 知道 怎么 评 的	__label__2
我 是 为了 看 吴亦凡 买 的 票 结果 没有 吴亦凡管 上海 蜡像馆 借 的 已经 还给 人家 了 非常 伤心 就 为 吾 凡 来 的	__label__1
在 门口 望了望 没 进去 应该 没 啥 好看 的	__label__2
毛毛 他 老人家 把 传承 多年 的 国门 扒 了 自个儿 躺 在 那里 了 话 说 是不是 想 自己 去 守 国门 呢 国足 应该 赛前 去 拜 一拜 祈求 好运	__label__1
去 的 时候 雪 还 不够 厚 没有 看到 雪 蘑菇 而且 里面 没 开灯 好 没意思	__label__2
喀斯特地貌 很棒 周围 都 很 舒服 很 好 仿佛 置身 电影 的 感觉	__label__2
人多 就是 小吃街 价格 贵 并 不是 好吃 的 其实 在 每个 人 的 家乡 都 会 有 这些 吃 的 并且 很 好吃 大家 就是 爱 热闹 不 建议 来 吃 看热闹 就 好	__label__2
有 不少 的 咖啡馆 适合 闲暇 时 的 小聚 或者 情侣 间 的 约会	__label__2
室内环境 欠佳	__label__2
确定 嵊泗 主岛 这里 也 就 这个 沙滩 可以 逛逛 先说 说 整体 感受 整个 城市 仿佛 都 只 认钱 东西 都 是 随便 要价 的 在 街边 零售店 一瓶 矿泉水 要块 可是 刚才 在 隔壁 不远 的 店 买 才 块 啊 然后 海鲜 都 超贵 还 不如 在 上海 吃 再说 说 这个 海滩 这个 沙滩 朝 东 所以 看不到 日落 但 日出 也 看不到 因为 早上 不让 进 买票 都 不行 因为 没 营业	__label__2
古文化 街到 晚上 六点 就 关门 了 看门 的 大爷 特别 凶 都 把 我 女朋友 吓哭 了	__label__2
门票 元 门口 停车场 不 大 收费 好像 是 十元 吧 名气 大 但 实践 真的 没有 什么 景色 很 失望 园中 很小 很快 就 转完 了 主要 有 三座 庙 财神庙 、 娘娘庙 和 玉皇顶 娘娘庙 香火 很旺 比较 耗时 的 是 登 主峰 全是 石头路 和 土路 开发 得 很 不好 原汁原味 地 登山 上山 还好 下山 特别 容易 摔跤	__label__2
就 一坑 爹 景区	__label__1
鲁迅 的 一篇 文章 让 孔乙己 和 咸亨 被 永远 记住 酒店 门口 还 挂 着 孔乙己 欠钱 的 牌子 感兴趣 可以 去 瞧瞧	__label__2
漪澜 堂 是 乾隆 三十六年 仿照 镇江 金山寺 建造 的 原为帝 后们 泛舟 、 垂钓 后 休息 、 进膳 之所现 为 仿膳 饭庄	__label__2
有 电梯 的 古楼 你们 要 去 吗 在 外面 看看 就 好 了	__label__2
景点 未 全部 装修 完毕 携程 的 票价 可以 门口 购票 窗口 服务态度 差 旅游 规则 随意 改变	__label__2
画像 的 一个 人加膜 元贵 死难 看死 了 人家 什刹海 湖边 一个 才 元 那个 才 好	__label__2
厦门 之 行	__label__1
说实话 真的 好 失望 大明湖 里面 只有 嬷嬷 没有 格格 且 风景 很 一般 付费 的 地方 和 不 付费 的 一样	__label__1
挺 新奇 也 挺 好 但是 乐趣 只到 照个 像 为止 了 如果 不是 蜡像 艺术性 也 不强 性价比 不高	__label__2
相当 小小 学生 可以 逛逛 不 知道 倒闭 了 没	__label__1
这里 就是 一个 湿地 公园 很多 个 城市 自己 也 有 这些 的 地方 所以 不是 很 推荐	__label__2
年初三 排队 买 的 票 淡季 一位 包含 大 门票 祈年殿 园 丘坛 回音壁 个人感觉 花元 买个 公园 门票 进去 看 下 就行了 或者 索性 就 不 去 天坛 了 这天 去 人 特别 多 祈年殿 外面 是 被 围起来 的 不能 进屋 参观 的 就 那 一扇 小 门口 挤满 人 压根 看不到 房内 的 东西	__label__2
商业街 中端 消费 卓展 值得 一去	__label__2
没有 退 差价 导游 失踪 携程 不理 人白坑	__label__1
不错 的 皇家 建筑 、 体现 古文化 的 精髓	__label__2
活 受气 不好玩 服务态度 不好 赶人 下次 不去 啦 无言 无言	__label__2
太 无聊 了 为什么 是 级 景区 啊 不 懂	__label__1
完全 不 推荐 没 啥 看头 还是 自然风景 比较 迷人	__label__2
前 几天 去 在 塔尔寺 步行街 口 有人 专门 拦 外地 车 让 左转 进 他们 的 停车场 而 所有 本地 车则 是 直接 放行 感觉 有些 蹊跷 就 询问 拦车 人 被 告知 当地 车 都 有 通行证 我 说 没有 看到 通行证 结果 傍边 就 有人 过来 骂骂咧咧 手 伸进 我车 内乱 拉 我 很 生气 见状 就 掉头 回 了 西宁市 从 乌鲁木齐 自驾 走 了 多公里 到 了 塔尔寺 门口 却 没有 进去 遗憾 的 同时 为 景区 管理 失望 感觉 他们 是 在 给 大美 青海 抹黑 望 及时 治理整顿 因为 没有 看到 景色 所以 无法 给予 公证 客观 的 评价 但是 特色 和 服务 真是 无法 恭维 的	__label__1
水立方 全称 国家 游泳 中心 位于 北京 奥林匹克公园 内年 北京 奥运会 标志性 建筑物 之一 其 与 国家 体育场 分列 于 北京 城市 中轴线 北端 的 两侧	__label__2
在 双阳 吊 水壶 公园 内在 炎热 的 夏天 洞内 冰天雪地 别有 一番 风味	__label__2
不会 来 第二次 了 机动 游戏 不如 长隆 饭菜 坑爹 我 第一次 去 旅游 吃 这么 多 白饭 的 因为 没菜 吃 而且 很 难吃 唯一 值得 赞 的 是 在 山谷 间 坐 小 火车 但 劝 大家 还是 别去了	__label__1
与 家人 同行 至此	__label__1
除了 空气 好 其他 都 不好	__label__2
没什么 特色 我 的 史 上 最差 的 一次 旅游 人少 中午 就 我 一个 人 游玩 阴森森 的 洞 我 不敢 进去 看	__label__1
冲着 秦淮河 晚上 来 了 夫子庙 秦淮河 现在 太 商业化 了 各处 可见 旅游团 完全 没有 到处 看看 的 欲望 在 夫子庙 门口 坐 了 观光车 我 终究 是 没有 进去	__label__2
感觉 挺 失望 的 门票 预订 倒 是 非常 方便	__label__2
没意思 花 也 不 多 里面 有 购物 的 点	__label__2
可玩性 很 低	__label__2
订票 服务 方便 直接 手机 验证 取票	__label__2
四川 快成 云南 都 成 购物 团 了 希望 自由 行 的 朋友 不要 参加 一日 或 多日 游	__label__1
坑爹 的 古城 维护费 也 不 知道 为什么 要 把 木府 和 紫禁城 比 没有 可比性 啊	__label__1
千万 不要 去 地方 偏僻 还 没什么 风景 关键 是 根本 对不起 门票 钱 感觉 一百多块 白 扔 了 如果 你 是 土豪 而且 时间 充裕 那 就 去 吧	__label__1
就是 一 普普通通 的 小山	__label__1
徽州 之行 中 宏村 名气 是 最大 的 但是 我 期待值 是 最低 的 哈哈 因为 一起 的 小伙伴 们 说 去 看看 那么 也 当 是 到此一游 除了 两个 湖 我 还 真是 喜欢 呢 可惜 人太多 不能 好好 拍照	__label__2
全国 各地 有 好几个 鬼谷 洞 鬼谷子 是 魏国 人 出生 在 今天 的 河南 怎么 回去 湖南 其实 就是 景区 生硬 扯 典故 以 吸引 游客 在 天门山 山顶 西线 的 一块 峭壁 上 有 一个 方形 洞口 那 就是 天门山 十六 洞里 最为 著名 的 鬼 谷洞 这个 洞上 距 山顶 百米 下临 深渊 万丈 地势 险峻 一般 人 是 无法 进去 一探 究竟 的 直到 年 天门山 才 再次出现 了 一个 探洞 的 勇士 — — 李光玉 他 自年 至 年 先后 次 从 悬崖 的 上方 垂 绳索 下 绝壁 与 鬼 谷洞 进行 了 亲密 接触	__label__2
没有 什么 特别 满街 都 是 不 知道 谁家 正宗	__label__1
逛 高价 公园 般的 感受 人 看 人人 跟着 人 走 抢 拍照 位置 除了 三个 瀑布 到处 都 是 人工 景观	__label__2
对于 身体 欠佳 的 人 来说 景山 的 高度 还是 蛮 有 挑战性 的 不过 爬 到 山顶 即可 一览 故宫 的 全貌 甚至 可以 看到 长安街 、 国家博物馆 、 人民大会堂 、 国家大剧院 等 地标 性 建筑	__label__2
名气 大 实际 内容 并 不算 多	__label__2
早早 计划 好 来看 竟然 全封闭 装修 不 开放 从 月 号 封闭 筹划 长征 周年	__label__2
不让 进 不让 进 字儿 少 不让 评论	__label__1
什么 都 要说 钱 而且 死贵 下来 的 时候 你 是 无法 选择 的 必须 坐 大巴车 上 到 买 门票 的 地方 单程 元 一人 还要 强行 加 保险 元 一人 而且 买 了 门票 如果 选择 坐 索道 上去 还要 元 一人 也 是 单程 反正 返程 同价 而且 里面 只有 卖 烤 肠 玉米 之类 的 小吃 的 如果 要 吃饭 只有 餐厅 才 有	__label__2
预定 不 成功	__label__1
都 没有 了 的 地方 了 排名 还 这么 靠 前小编 工作 要 认真 了	__label__1
人太多 了 交通 混乱 北京 的 小吃 估计 全国 没 几个 地方 的 人 吃 的 惯 吧	__label__2
一个 很 浮夸 的 建筑 说 是 一个 佛教 建筑 其实 就是 一个 会议 中心 大堂 穹顶 是 挺 漂亮 的 但是 太 刻意 了 如果 是 为了 欣赏 佛教文化 的 不 推荐	__label__2
北修 故宫 南修 武当 这是 一句 说发 就是 与 北京 的 故宫 一起 修建 的 是 一处 皇家 寺庙 武当 的 金顶 是 一个 好 的 景致	__label__5
不 咋 滴 体验 了 一番 过山车  还 不错 其他 的 各种 维护 中	__label__2
黑马河 乡 我 相信 大部分 选择 在 这里 住宿 的 驴 友们 都 是 为了 用 一个 目的 青海湖 日出 只不过 这里 的 住宿 我 实在 不敢恭维 在 旺季 假如 有 独立 卫浴 小时 供应 热水 的 房间 随随便便 都 可以 要价 八百 大洋 我们 到达 黑马河 的 前 一个 晚上 据说 这里 还 下 了 场 大暴雨 外加 停电 想象 一下 在 一个 风雨交加 的 夜晚 没有 电 漆黑一片 缩 在 连 电热毯 都 罢工 的 冰冷 床上 简陋 的 蒙古包 外面 就是 一片 荒芜 一天 的 疲倦 外加 吸满 臭汗 的 身躯 却 连 卫浴 都 没有 晚上 去 个 洗手间 既要 淋 着 雨 还要 被 不 知名 的 动物 叫声 吓个 半死 第二 早带 着 严重 黑眼圈 的 面孔 如此 体验 告价 二百五十 大洋 因此 我 推断 这里 的 日出 绝对 是 极品 能 看到 的 都 是 真爱	__label__2
不 推荐 真心 没什么 意思 千万别 登顶 的 不要 买买 的 就 行 被 坑 了 的 什么 太空舱 根本 是 骗人 的 什么 都 没有 只有 透明 走廊 还 可以 一看 其他 真的 一般 没 去过 的 时候 总想进 东方明珠 进 了 发现 也 不过如此 没 啥意思	__label__2
一路 爬上去 全是 坟 有次 去 天柱山 池塘 里面 的 水 抽 了 看见 池塘 里面 有 很多 凸起来 的 小洞 一问 才 知道 那 池塘 里 尽 是 坟 给 提走 了 的	__label__1
阿姨 老太太 为了 拦 你 的 车 恨不得 扑 到 你 车上 刚 开始 还 以为 碰瓷 呢 原来 是 为了 拦 你 停 她家 位置 收 停车费 吓坏 宝宝 了 刁民 多	__label__1
仿古 的 建筑 建筑 外面 被 各种 广告 占据 影响 了 形象 国庆 去 居然 没什么 人 垃圾 没 人 清理 不 值得 专门 去	__label__2
其实 里面 没什么 看 的 只是 沉船 和 一些 打捞 船上 的 东西 不过 附近 的 沙滩 不错	__label__1
当年 张艺谋 的 印象 系列 很火 杭州 刚有 印象 西湖 的 时候 就 赶着 过来 看 当时 真的 是 完全 的 惊艳 一 开场 湖面 漆黑 一盘 明月 悠悠 升起 一袭 白衣 也 缓缓 从 远方 地 水面 飘来 近 了 一 看 是 一 玉面 书生 摇着 纸扇 正要 开启 故事 的 序章 是 的 当年 的 印象 西湖 是 一出戏 有 章节 更 有情	__label__1
没 必要 去 下车 以后 往 景点 走 的 距离 比 天池 还要 远路 窄 人 多 其实 就是 一个 大水坑 水不太清 有 漂浮物 没 必要 浪费时间	__label__1
免费 的 人家 就 伫立 在 那里 你 看 与 不 看	__label__2
元旦 出游 静之湖	__label__2
分别 于 日 乘坐 火车 来 的	__label__1
一点 都 不 值得 去 都 是 些 劣质 的 新房子	__label__1
接车 司机 太 差劲 人 没 接到 司机 还 撂挑子 非常 不 满意 我 打算 卸载 去 哪儿 玩 软件	__label__1
仅当 散步	__label__2
本来 是 公共 的 资源 被 村匪 圈起来 强行 收费 简直 无法无天	__label__2
我 等 凡人 不足以 体验 这里 的 历史 厚重	__label__2
这是 西安 之行 最坑 爹 最 无趣 的 景点	__label__1
千万 不要 去 我们 买 了 庐山 景区 门票 想 去 看看 李白 写诗 的 瀑布 就是 这个 三叠 泉 呵呵 工作人员 说 只能 坐 缆车 过去 再 走 两分钟 就 到 好 我们 就 花块 过去 缆车 特别 旧 · · · · 到 了 那边 我们 走 到 三叠 泉 路口 时 居然 发现 还要 再 买票 感觉 庐山 很 容易 就 会 被 人 骗 所以 大家 小心 三叠 泉 也 没 啥 好看 的 真的	__label__1
水 很 清 但是 个人 觉得 不值 这个 价 走路 分钟 基本 走 完	__label__1
要是 想 去 还是 放弃 吧 毫无 特色	__label__1
一次 不 愉快 的 买票 经历	__label__1
五大连池市 五 大连市 风景区 极差 评 黑龙江 经济 发展 欣欣向荣 无限 美好 啊 今天 打 出租车 去 五大连池 老黑山 景区 结果 出租车 司机 把 我 送 了 堰塞湖 景区 收 了 车费 后来 发现 不 对 明明 要 去 山 的 怎么 是 湖 、 司机 不仅 不 承认 送错 了 地方 说 什么 到 老黑山 只能 水路 不能 陆路 除非 他 车子 能 游水 才能 到 老黑山 景区 还 找 了 一个 其它 的 司机 装做 景点 的 工作人员 给 他 做 证明 但是 任何 景点 的 旅游 图 都 有 啊 明明 可以 陆路 去 老黑山 的 最后 就是 他 走 了 我 就 只能 回走 了 从 堰塞湖 回到 风景区 入口 有 公里 觉得 这是 明显 的 诈骗 行为 其中 我 在 路上 两个 景点 处问 景点 工作人员 回去 的 大巴 哪里 坐 景点 的 售票员 说 问进 景点 口 的 工作人员 进 景点 口 的 工作人员 说 这个 要 问 停车场 停车场 的 工作人员 说 你 打车 吧 没有 大巴 打车 我 就 呵呵 了 我 真是 呵呵 了 黑龙江 建设 真是 好长 这么 大 旅游 去过 的 个 省里 就 发现 黑龙江 最好 今天 真是 好开心	__label__1
实际 就是 个 街心公园 呈 条状 从 南河沿 到 北河沿 东面 不远 是 王府井	__label__2
希望 可以 帮到 你	__label__2
没 去过 不 知道 在 哪 呢 好景 太多 了 这样 的 就算 了 吧	__label__2
其实 就是 和 古镇 一样 的 啦 但是 我 觉得 门票 太贵 看 的 景点 也 少 不过 当初 神奇 侠侣 好像 就是 在 这里 拍摄 的 过年 的 时候 还有 元宵节 的 时候 会 比较 好看 有 花灯 还有 舞龙 舞狮 特别 热闹 更 有 小镇 的 感觉	__label__2
噩梦	__label__2
去 都江堰 都 有 半个 月 用 携程网 订张 门票 省元 钱 它 提醒 要 写 点评 可 抽奖 赶紧 写 几句 都江堰 值得 一游 景色 不错 希望 能 中奖	__label__1
庐山会议 旧址 我们 不太 喜欢 人文 的 东西 觉得 假 的 太 多 可能 老年人 比较 喜欢 吧	__label__2
太多人 各处 景点 排队 至少 花 了 小时	__label__2
没什么 好看 的 不值	__label__2
很 没劲 没什么 看 的 里面 饭馆 不少 但 都 基本 没 人 还要 每人 元 的 门票 真的 是 没什么 看 的 被 百度 旅游 骗 了 还 以为 都 好看 呢	__label__1
不 建议 没什么 特别 可看 的 如果 逛街 什么 的 建议 去 天一 广场 很近	__label__2
既然 是 以 爱国主义 教育 为 主题 的 旅游 景区 门票 居然 还 这么 贵 不禁 感慨 这年头 想 爱国 都 爱 不起 了	__label__2
雄浑 的 嘉峪关 当然 很 值得 — 去 穿梭 其间 感觉 到 自己 的 渺小 感受 到 历史 的 沧桑 同时 也 恍惚 时光倒流	__label__2
差评 差评	__label__1
就 一条 小弄子 感觉 没什么 看 的	__label__2
博物馆 维修	__label__2
就 剩下 自然风光 了 古迹 基本 都 被 烧光 啦	__label__2
初来 杭州 不要 去 啊 外面 的 大好河山 等 着 你 呢	__label__2
非常 差 不会 再 去 第二次 大家 也 不要 去	__label__1
携程 买票 没 问题 但 不 建议 近年 去 迪斯尼	__label__1
挺 失望 的 一次 游园	__label__2
仙岩 风景区 门口 向右走 那条 公里 上去 全是 坟地	__label__1
就是 一个 人工 建 的 古镇 里面 都 是 酒店 和 饭店 没有 什么 特色 而且 人 很少	__label__1
到此一游 的 打卡 景点 没什么 意思 反而 是 牌坊 下面 的 老街 比较 有 特色	__label__2
累	__label__1
老虎滩 这边 的 雕塑 啊 什么 的 基本上 都 是 在 景区 内 但是 现在 圣亚远 超 老虎滩 逼 得 这边 的 生意 惨淡 虽然 我们 没有 进去 参观 但是 感觉 人好 少 很 冷清 而且 周边 公共服务 做 的 不尽人意	__label__2
不要 把 它 当做 迪士尼 还是 可以 玩玩 的	__label__2
开车 到 门口 只是 问路 被 强行 引导 进 停车场 几百辆 车 就 开 两个 收费口 出 停车场 堵 了 分钟 保安 对 我 说 你 有 本事 飞过去 啊	__label__1
从来不 写 评价 的 这次 忍不住 了 去 长城 选择 的 是 火车 北京北站 进去 刷 公交 卡到 八达岭 后出 站 也 要 刷 真是 运气 爆棚 了 在 车上 就 下雨 了 早上 第一趟 是 六点 多 没 赶上 坐 的 的 一趟 离开 车 还有 好长 好长时间 进站 口 已经 很多很多 人 了 进站 真的 是 百米 冲刺 抢 座位 搞不懂 为什么 不多 弄 几节 火车 差不多 一个 小时 二十分钟 就 到 了 火车 里 跟 高铁 差不多 不过 就 四节 到 站 后 又 提 的 干粮 和 水 又 下 暴雨 真是 倒霉 有 雨衣 卖 五块 一个 山 底下 有 免费 接驳 车 建议 准备 徒步 爬 长城 的 不要 坐 这个 车 就 直接 把 你 拉 到 坐 缆车 的 地方 下车 后 的 售票点 只有 买 缆车 才給 你 卖 长城 门票 走 到 徒步 爬 长城 的 地方 还 很 远 很 远走 的 北线 因为 大雨 就 爬 了 两个 烽火台 第二个 烽火台 的 坡 已经 非常 之 陡 了 并且 我 的 鞋 也 坏 了 去 火车站 的 那条 街有领 好汉 证 的 地方 进去 照相 他会 先給 你 介绍 有 照片 的 证书 的 你 可以 不要 拿 一个 证书 去 一楼 有 照片 就是 比较 小拿上 可以 盖个 钢印 免费 还 可以 免费 打印 两张 手机 里 的 照片 八达岭 火车站 很小 依旧 坐 一点 四十 的 火车 离开 还有 很 长时间 已经 有 很多 人 排队 了 站 里 有 卖 火车票 的 可以 随时 坐 其中 一趟 最迟 发 往 北京 北 的 是 晚上 九点 爬 长城 其实 就是 爬山 真的 是 不到长城非好汉 到 了 长城 好 遗憾 不 建议 小孩 和 老人 去 穿 防滑 鞋	__label__1
项目 太 少	__label__2
所谓 的 艳遇 之 城 不过 是 安脏 的 交易 整个 古镇 感觉 太 商业化	__label__1
北海 之游	__label__2
停车 乱收费 有些 区 封闭 了	__label__1
令人 失望 的 广州 塔	__label__1
没什么 映像 了 年 去 的 现在 都 已经 过 了 年 了	__label__2
目前 去 了 无纹村 如果 有 免费 导游 的话 她 会 带你去 一个 叫 天师 孝母 的 地方 里面 有 师傅 写毛笔字 的 他们 会 免费送 你 福 然后 去 里面 拜 天师 然后 就要 & ; 捐 以上 的 款 & ; 了 然后 导游 不见 了   	__label__2
越来越 差 的 北京 欢乐谷	__label__2
总体 感觉 不佳	__label__2
那天 是 误打误撞 到 的 南栅 这里 不是 景区 就是 一般 的 村子 的 感觉 就 像 所有 地方 的 城乡 结合部 偏 乡镇 那 一部分 一样 老旧 的 房屋 在 那里 生活 着 的 人们 相比 西栅东 栅 的 景区 商业化 这个 倒 是 更 生活化 但是 你 不可否认 的 是 生活化 的 村子 并 不 适合 旅游观光 南栅 也 会 有 一些 老宅 其实 那 是 完全免费 的 但是 在 路口 会 有 老头 老太 把 你 拦下 要 你 付钱 说 这 是 景点 要 买票 才 进去 的 票价 倒 是 不贵 块钱 一个 人 但是 这本 就是 个 免费 的 地方 你们 却 拦路 收 过路费 这种 做法 实在 是 太 恶心	__label__2
所谓 什么 草原 我 觉得 无非 就是 公园 里 的 一片 草坪 而已 任何 一个 城市 都 有 很 普通	__label__2
是 我 去过 最烂 最破 的 地方 评论 害死 人 里面 根本 没 人 风景 也 没有 非常 的 小 周边 都 是 民工 在建 房子 非常 的 偏僻 叫车 都 不好 叫 太 垃圾 了 坑 爹	__label__1
只 给 两星 第一 当地 管理混乱 交通不便 上去 打车 上车 块 中间 加块 到 上面 下来 要 几个 黑车 商量 好 的 全 一个 价 公交 太少 了 几小时 一般 自 驾上去 的 停车 厂 是 在 里面 千万别 被 外面 圈地 的 人 指挥 这里 飞风 可不 淳朴 第二 质量 差 门口 小摊 路 堵死 了 摆 吃 的 桌子 摆 路上 各种 环境 垃圾 里面 也 是 禁烟 标语 形同虚设 观星 的 去 前 看好 空气质量 滑雪 泡温泉 的 早些 上去 中午 都化 了	__label__2
厕所 太 少 自行车 太 垃圾 骑 起来 困难 的 不得了	__label__1
路过 在 远处 眺望 了 下 没上去	__label__2
此生 不想 再 去 全是 骗钱 的 浙江人 啊	__label__1
以上 都 是 对级 风景区 黄山 风景区 的 吐 槽 自助 取票 机坏 了 等 了 好久 才 修好 还 不如 电影院 的 机子 或者 火车站 车票 售票机 稳定 耽误 了 很多 人 的 时间 和 大级 身份 不 匹配	__label__1
景点 真的 很 一般	__label__2
真心 觉得 不怎么样 票贵 半个 小时 就 走 完 了	__label__2
就 去 了 一次 吧 上学 那会儿 的 事儿 了 印象 很深 的 是 古代 攻城战 用 的 狼牙 拍 那样 的 家伙 什儿	__label__2
除了 破破 的 旧 房子 啥 都 没有	__label__2
一般般 价格 有点 贵出票 速度 还 可以 里面 没 啥 可 看 的	__label__2
一点 都 不 好耍 啥 都 没有 热 的 要死	__label__2
装 工作人员 骗人 拉客 的 很多 且 很多 都 是 新盖 的 旧 房子 没 任何 观赏价值 非常 不值 票价	__label__2
取票 简单 晚上 上面 很 冷 但是 景区 没什么 东西 服务 跟不上 台阶 安全 和 游客 引导 跟不上 这么 出名 的 景点 值得反思	__label__2
索道 现在 的 价格 都 是 以上 都 要 元 而且 还 没有 往返 价格比 之前 几次 去 都 高 了 很多 一到 要 拍照 的 地方 就 很多 穿着 蓝色 大褂 的 都 在 骗钱 而且 很多 人 都 没 素质 都 不 排队 坑 死 人 了 上面 的 玉皇顶 越来越 冷风 大	__label__2
大 裤衩 大 裤衩 大 裤衩 最 明显 的 就是 堵车	__label__2
朋友 听说 莫干山 很 好玩 是 国内 四大 避暑胜地 之一 于是 我们 就 特意 来 杭州 的 第一站 就 去 了 莫干山 果然 是 攻略 做 得 不够 啊 这个 地方 完全 只 适合 自驾游 不 开车 的 盆友 还是 别去了 吧 山上 景点 与 景点 之间 都 距离 挺远 的 看着 别人 都 是 开着 豪车 在 景点 间 穿行 我们 几个 靠 步行 奔波 的 简直 是 悲剧 山上 有 很多 黑车 的 价格 嘛 看 你 能 砍 到 什么样 了 哦 至于 景点 嘛 我 只 想 说 人文 色彩 也 不 浓 自然景观 就 不 说 了 重点 是 并 没有 很 凉快 啊 这 就 相当 尴尬 了 倒 是 山脚下 有些 民宿 还 挺 有意思 的 说	__label__2
全是 眼泪	__label__1
对于 我们 普通 游客 来说 确实 没有 太大 的 特色 没有 惊喜 看过 后 也 不会 给 朋友 推荐 不会 再 去 的 地方	__label__2
实话 讲 并 没有 去过 这么 一般 的 级 景区 整个 景区 占地面积 不小 故居 本身 是从 其他 地方 迁过来 的 文化底蕴 也 并 不 深厚 如果 时间 紧 并 不 推荐 过来 当然 和 三峡大坝 是 一条 旅游 线路 可以 顺路 过来 参观	__label__2
好多 地方 在 施工 门票 好贵 不值 这个 价钱	__label__2
这个 是因为 时间 有限 没有 去 攻略 里面 都 说 因为 这个 距离 有点 远 如果 在 时间 不 允许 的 情况 下 可以 考虑 放弃	__label__2
从 岳麓山 的 南门 上去 离爱 晚亭 比较 近 不能 作为 一个 单独 的 景点	__label__2
朱墙 金瓦 朱门 金钉 可以 说 是 故宫 建筑 的 最大 特色 环境 不错 护城河 护 城墙 北京故宫博物院 仅 有 的 气派	__label__2
这 地方 就是 一个 不 来 后悔 来 了 更 后悔 的 景区 门票 很 贵	__label__2
不 推荐 去 天门山 到处 在 装修 山上 到处 乌烟瘴气 一点 都 不值 的 门票	__label__1
除了 看看 唐三藏 的 足迹 以外 没什么 好玩 的	__label__2
不得不 说 这个 景区 的 管理 实在 太太 差跟团 去 的 漂流 加 浙西 大 龙湾 两个 是 一个 景区 都 必须 乘 景区 中巴车 进出 的 在 大 龙湾 那里 的 中巴车 回 大门口 的 等 车点 完全 没 人 管理 毫无 秩序 可言 只要 看到 车来 了 几十个 人 上去 扒 车门 都 不怕 出 事情 的 在 那里 装个 栏杆 来 个人 管理 会 死 么 造成 这么 混乱 完全 是 景区 的 责任 好不好 还有 漂流 也 是 月份 是 旺季 人多 是 排队 是 能 理解 到 了 那里 直接 说 没有 救生衣 了 让 游客 自己 抢 自己 抢 就是 运 救生衣 的 车开 过来 几百人 围着 车 抢 里面 的 救生衣 都 不怕 踩踏 事故 么 难道 不能 车子 运到 里面 有 排队 号 的 进去 了 再 穿 这 就 导致 了 有 救生衣 的 无所事事 等 排队 的 人 没有 救生衣 这 管理 简直 了 导游 说 开园 几年 来 每年 都 这样 从来 都 是 管理 那么 混乱 没有 人管 的 要 去 那里 漂流 的 朋友 自己 掂量 一下 自己 是不是 人高马大 能 挤 得 过 别人 抢 救生衣 和 短驳 中巴 从来 没有 一个 景区 管理 能乱成 这样 的	__label__1
景区 价格 高 但 趣味 不高 不 值得 推荐	__label__2
我 的 眼里 只有 人 而且 道路 很 狭窄 实在 是 差评	__label__2
天下 西湖 三十六 各 各 都 别有风味 值得 去 看看	__label__1
感觉 就是 将 北京 的 古老 的 胡同 改造 为 现代 的 商业街 古老 的 胡同 韵味 在 消失 商家 大捞 快 掙 的 心态 正在 毁掉 胡同 的 古韵	__label__2
不 开心	__label__1
这 是 在 博物馆 旁边 不 留神 就 会 忽略 过去 集中 展示 了 苏州园林 建园 、 理水 、 叠石 等 的 理念 、 手法 让 人 更 全面 深入 的 了解 园林 之 内涵	__label__2
位于 天子山 区域 在 天子山 景区 停车场 附近	__label__2
找 不到 厕所 厕所 特别 少 还 被 随意 维修 当 你 憋不住 的 时候 那酸爽	__label__2
地方 很大 走路 也 走 了 就 很 然后 冬天 去 的 时候 很 冷 街边 很多 卖 冰糖葫芦 的 人 稀稀拉拉 的 来 玩 的 散步 的 都 有 挺 干净 的 还有 一些 小摊 点	__label__2
爬上去 要 收费 挺贵 的 只 在 下面 照 了 几张 相	__label__1
我们 去 的 时候 水帘洞 已经 变成 水线 洞 了 没有 水帘 水 很少 这个 地方 还 挺 远 的 景色 一般般 不是 很 推荐	__label__2
当 雷峰塔 有 了 电梯 不伦不类 的 感觉 实在 是 让 人 感觉不好 完全 的 新 样式 观光 塔 登高望远 关怀 上岁数 的 人 都 是 不错 的 只是 塔 本身 毫无 特点 可以 看 对 白蛇传 说 痴迷 太深 导致 对 景点 的 评价 高 不 起来 门票 感觉 不值 性价比 低	__label__2
丽江 古城 并 没有 大家 口中 所说 的 那么 好玩 古城 里面 基本上 都 是 客栈 酒店 和 卖 小商品 的 店铺 而且 里面 的 价格 也 比较 高 除了 丽江 在 以后 在外 会 有 很多 接客 人员 像 妓院 的 老鸨 一样 非常 的 热情 而且 会 一直 和 你 瞎 逼 逼 千万 不要 理他 否则 只要 你 有 一丝 的 犹豫 你 就 会 被 坑 他们 先 会 详细 的 问 你 的 行程 然后 不停 的 和 你 说 这 说 那 我们 当时 是因为 他 说 块钱 可以 去 一个 比较 远 的 景点 拉市海 玩 一下 我 觉得 挺 划算 的 所以 就 跟着 去 了 然后 他 还 说 玩完 了 之后 回接 我们 去 古城 那里 结果 把 我们 丢 在 那个 私人 马场 里面 那个 马场 的 名字 叫 马帮 传奇 那个 路上 好像 有 七八个 马场 大多 都 是 私人 开设 的 然后 把 我们 丢 在 那个 马场 里面 就 会 有 马场 的 人 给 我们 介绍 线路 一到 线路 不同 的 线路 玩 的 景点 不 一样 这些 线路 票价 都 比较 高 不过 都 是 坑人 的 他们 还 说 是 旅游局 定 的 价格 总之 细节 方面 我 就 不 多 说 了 千万 不要 去 私人 马场 如果 想 去 玩 可以 去 报个 旅行团 块钱 左右 而且 拉市海 也 是 一个 比较 小 的 湖泊 在 很多 地方 都 可以 见到 丽江 并 没有 网上 说 的 那么 好玩 而且 丽江 的 几个 景点 都 比较 分散 泸沽湖 香格里拉 距离 丽江 火车站 都 比较 远 然后 他们 包车 的 费用 也 比较 贵 如果说 你 想 报 旅行团 的话 中间 可能 会 有些 不 愉快 因为 中国 的 旅行社 并 没有 那么 透明 我 感觉 丽江 就是 一个 比较 偏僻 的 小镇 和 昆明 的 大气 相比 远远 不能 和 昆明 相比 可 你 一个 人 的 素质 都 比较 高 老人 会 说 普通话 大部分 而且 也 非常 有 素质 在 昆明 玩 了 三天 没有 花到 块钱 这 昆明 的 各大 景点 都 可以 坐 公交 非常 的 方便 但是 丽江 的 公交 特别 少 所以 就 造成 了 跑 私家车 的 人 特别 多坑 的 人 也 特别 多 在 丽江 你 可能 玩 一个 景点 就要 两三百 但是 在 昆明 把 所有 的 景点 玩 下来 都 不用 我们 是 用 的 学生证 买 的 票 所以 说 比较 便宜 然后 在 昆明 住 的 也 是 青旅 听说 大理 的 苍山 洱海 比较 好玩 但是 由于 时间 关系 没有 去 成 旅游 就是 体验 一种 在 没来 之前 和 来 了 之后 的 那种 巨大 落差 的 感觉 你 将 古城 来 转一转 也 是 好 的 因为 很多 女 的 都 向往 这片 土地 说不定 还 能 有 一场 艳遇 但是 如果 让 你 失望 了 不用 开心 因为 中国 的 很多 景点 都 已经 被 商业化 说 了 这么 多 希望 能 被 更 多 人 看见	__label__1
靖江 王府 门票 携程网 上定 的 真心 不值 太坑 了 里面 的 建筑 都 是 重建 的 只能 看个 外壳 兼职 就是 个 人造 景点 景区 内 唯一 的 看点 就是 登上 独秀峰 看 桂林市 块 真心 不值	__label__2
非常 坑爹 的 景点 也 就是 名气 大 一百块 的 门票 里面 还要 坐 电瓶 小 火车 全程 通票 其实 就 两段 类似 海边 没什么 好看 的	__label__2
黄鹤楼 真的 是 一个 噱头 翻新 之后 在 翻新 楼 里 大部分 都 是 卖 纪念品 的 付过 高昂 的 门票 之后 最能 看 的 也 就是 顶层 的 观景台 了 那里 能 俯览 长江 和 长江大桥	__label__2
开启 了 烧烤 模式 的 迪士尼 之旅	__label__2
有点 偏僻 有点 落后 虽然 设施 不好 不过 也 是 东北 农村 的 淳朴 气息	__label__2
说实话 对 秦皇岛 蛮 失望 的 老龙头 的 建筑 完全 没 啥 亮点 走 到 哪里 都 在 施工 尘土飞扬 呼吸 都 不 舒服 当地 的 服务 也 真的 很差 原来 是 五星级 现在 被 取消 了 可想而知 不 推荐 过去 感觉 就是 打着 文化 的 幌子 建了 很多 古建筑 挂 上牌 秦皇岛 的 沙滩 就是 把 海岸线 格成 一个个 沙滩 有点 石头 的 挂 个 名字 收 门票 没 石头 的 就 对外开放 大同小异 要么 就是 附近 建点 游乐 设施 变相 买票 进 景区 再收 门票	__label__2
道观 里 的 人 素质 有待 提高 服装 不 统一 感觉 很 不 舒服	__label__2
大家 千万别 买 了 特别 垃圾 说 的 和 给 的 票少 灵隐寺 的 门票 还 没有 单买 合适	__label__1
就 那样 有点累 了 洗洗 睡 吧 累 了 累 了 累 了	__label__2
就是 一 公园 不 喜欢 逛公园 的 人 不 推荐 服务 差 到极点	__label__2
贵而 不值	__label__2
有点 一般 新 弄 的 不过 其实 现在 都 差不多 有点 一般 新 弄 的 不过 其实 现在 都 差不多	__label__2
庙 是 好 庙 景色 优美 恢宏 大气 里面 的 工作人员 就 不怎么样 了 大殿 门口 卖香 的 把 免费 领取 三支 香 几个 字 用布 遮起来 在 那里 卖 高价 香讲 一些 神神 叨叨 的 东西 忽悠 游客 求 什么 东西 烧 什么 香 啊 等等 我 自己 拿 了 三支 免费 香上 完香进 大殿 给 东岳 大帝 磕头 里面 的 工作人员 竟然 教	__label__2
我 只 想 说 这 大概 是 我 这辈子 做 的 最 愚蠢 的 决定 要 来 庐山 看 瀑布 门票 一人 进来 除了 一些 树 一个 小 的 可怜 的 如琴湖 没什么 可看 想 说 看看 那个 李白 诗词 里 描述 的 瀑布 吧 到 了 含鄱口 必须 还 得 去 坐 缆车 也 就是 索道 一张 票 结果 就是 买 完票 排队 一个半 小时 坐 到 终点 十五分钟 天 就 黑 了 要 去 看 这个 李白 描述 的 大口 瀑布 还要 一人 再 买 一张 元 的 门票 想着 天 也 黑 了 在 那边 犹豫 了 一下 门口 站 着 三条 狗 凶神恶煞 对 我 吼 要 去 赶紧 的 买票 不 买票 就 滚上去 坐 缆车 回去 吧 你 还 出来 玩儿 什么 这 景区 的 工作人员 素质 跟 黑社会 有 什么 区别 大不了 不看 了 反正 看 完 回来 的 游客 都 在 大喊 失望 那 就 坐 缆车 回程 吧 足足 排队 两个 多 小时 山顶 寒风 一直 吹 队伍 移动 速度 极度 慢 还 下 起 了 小雨 好多 跟着 父母 过来 玩 的 小孩子 都 哭 了 真的 很 冷 很 累 很挤 回来 我 就 发高烧 了 加上 庐山 景区 到处 破破烂烂 地上 随处可见 的 垃圾 周围 游客 没 一个 不吐槽 的 这种 景区 还 不 取缔 完全 就是 欺骗 消费者 给 旅游业 抹黑 好歹 景德镇 的 瓷器 是 世界 文明 的 别 把 脸 丢 到 国外 去 了 旅游 千万别 来 江西 谁 来 谁 后悔	__label__1
与 想象 完全 不同	__label__1
地方 去一趟 差不多 了 一般般	__label__2
发 地震 探秘 预约 券 的 小伙子 太 差劲 了 态度 极差	__label__1
去 仓桥 直街 很 无聊 很多 店子 都 关着 或是 装修 是 一条 老街 很 老 很 老后 部分 做足疗 的 很多	__label__2
千万别 去 去 了 后悔 普通 的 村子 而已 没 啥	__label__1
乏善可陈 的 地方	__label__2
整体 零散 费用 太 多	__label__2
经过 住 了 一碗 早上 吃 了 一碗 面	__label__2
差劲	__label__1
西湖 不要 门票 那么 美 这 货要 门票 但 没 啥 好看 很 普通 不如 去 看看 园林	__label__2
来 一次 失望 一次 的 地方 要收 门票 白天 进个 古城 都 麻烦	__label__1
就是 大 海边 有 几块 石头	__label__2
管理混乱 收费 高 重复 收费 水质 差 容易 被 宰 人工 景点 不 建议 去 不要 忘记 白洋淀 最美 的 是 什么	__label__2
不好玩 不 推荐	__label__2
据说 此地 夜景 很 美 可惜 没 看到	__label__2
不 建议 去 门票 贵 仿造 各个 红色 景点 建造 浓缩 版本	__label__2
不 知道 该 怎么 形容 我 的 失望 想象 中 安详 、 静谧 的 古村落 景致 倒 是 和 宣传 照片 没有 太 差 只是 只有 身在其中 才能 感受 到 到底 有 多 拥挤 多 嘈杂 充斥 着 商业化 和 浮躁 的 情绪 甚至 比 城市 更 甚 池塘 里 的 水质 也 很 差 摩托车 不住 鸣笛 在 满 是 行人 的 狭窄 巷子 里 穿行 真不该 对 这种 名声在外 、 开发 多年 的 景点 抱太大 期望 从 汤口 坐 班车 到 宏村 的 小巴 每天 有 上午 八点 多 和 中午 一点 四十两 班 每人 元 沿路 招手 即 停 返程 收车 很早 票 早早 就 卖完 了 据 当地 宾馆 老板 介绍 包车 往返 平日 里 左右 节假日 翻倍 可以 说 是 漫天要价 我们 返程 单程 就 被 收 了 多 沿途 堵车 非常 严重 小巴 距离 宏村 公里 左右 就 堵住 了 现在 想想 倒 是 沿 公路 那 公里 徒步 满 有 感觉	__label__2
江湾 说 是 江泽民 的 老家 江湾 也 纯属 坑人 啊 一点 古建筑 都 没有 水泥地 为什么 能 成为 风景区	__label__1
天 除了 明显 的 五毛 和 少数 原住民 去 的 都 说 差 简直 不敢 去 了	__label__2
在 驴 妈妈 订 了 大小 门票 和 缆车 票 结果 到 景区 发现 大人 缆车 票 没有 订单 记录 进不去 退 又 退 不 掉 和 客服 沟通 了 半个 多 小时 才 让 我们 先 自己 买票 后面 再 解决 说 是 和 景区 沟通 核实 后 再 退款 结果 这 已 两天 了 还 没 结果 打 投诉 电话 一问三不知 也 没有 个 解决 时间 以后 再 不会 在	__label__1
清明节 去 的 人 挤 人 我 发现 山东 的 景区 建设 的 一般 吧 门票 缆车 都 比 别的 地方 贵 坑人 还有 一定 不要 做 桃花源 的 缆车 下 再 绕 到 市区 得 一个 小时 公交车 慢打 的 漫天要价	__label__1
漠河 之旅 失望 至极 碰上 一个 载客 司机 不 说 还 玩 的 不 开心 风景 看过 来看 过去 也 就 那样 就 过来 体验 了 一下 北方 的 寒冷 另外 提醒 下 驴 友来 漠河 千万别 上 火车 门口 的 那些 司机 的 车宰 你 真 不是 一点两点 的 还有 北红村 的 北红 宾馆 司机 就 爱 拉 你 到 这里 宰 网上 定 房间 费收 你 住宿 环境 差 还 很 吵 最 可恨 的 是 宰客 直接 放到 门 面上 的 菜单 上 就 来 个 菜 然后 价格 真他妈 呵呵 半只 鸡要 你 一个 萝卜 抄 木耳 一个 清汤 就 加点 蔬菜 都 要 还有 她 妈 他 这里 的 黄金 米饭 块 一碗 总之 蔬菜 全 肉类 的 都 要 以上 被 宰 心里 不爽 发 发牢骚 同时 也 算 给 大家 一个 提醒 吧	__label__1
风景 不错 交通 奇差	__label__2
古城 我 指 的 是 大研 古镇 白天 还 不错 晚上 简直 让 我 想 逃离 吵 的 要 疯 掉 了 以后 在 也 不会 去 更 不会 推荐 别人 去 了 完全 的 商业化 失去 了 古镇 的 意义	__label__2
康西草原 靠近 官厅水库 是 官厅 湖 的 另外 一边 但是 景色 截然不同 这边 的 太次 了 没有 草 了 只有 马 臭味 还有 沙地 摩托 环境 太差 不 推荐	__label__2
天下第一 雄关 之称 爬 爬 有些 陡	__label__2
很差	__label__2
名气 大 性价比 差	__label__1
世纪 广场 右侧 临接 江南 公园 左侧 临接 吉林市 博物馆 广场 的 地标 性 建筑 气势 宏伟 广场 面积 广泛 是 休闲 的 好去处	__label__2
天下 名山 牌坊 甚 是 一般 其于 年 月 重建 正额 天下 名山 为 郭沫若 年应 家乡 画家 李道熙 先生 邀请 题写 背面 佛教 圣地 由原 中国佛教协会 会长 赵朴初 手书 牌坊 高米 宽 米 四列 三跨 仿古 建筑 形式 飞檐翘角 古朴 典雅 具有 明清 风格 是 我国 目前 最大 的 牌坊 之一	__label__2
鼓浪屿 真的 没有 什么 好玩 的	__label__2
抱 着 很大 的 期待 来到 海陵 岛 看到 大角湾 落后 的 旅游 开发 真的 很 失望 大角湾 是 岛上 游客 最多 的 地方 不是 因为 海水 最清 沙质 最细 而是 因为 那里 有个 所谓 的 水上 乐园 这个 乐园 很 坑 爹 一次 票 两天 无限 次入园 是 我 在 这里 郑重 地 告诉 大家 千万 不要 因为 无限 次入园 才 贵 块钱 就 买 这种 票 因为 你 绝对 不会 来 第二次 里面 除了 几个 滑梯 之外 没有 其他 娱乐 设施 滑梯 公斤 以上 不能 玩 滑坡 又 要 单独 元租 气垫 才能 玩 而且 租到 气垫 后 得 自己 把 气垫 扛 上楼 滑下来 想 再 玩 又 得 自己 扛上去 所以 一个 人 最 多 玩 两次 就 没 力气 抗 了 里面 冲 淡水 另 收费 保险柜 另 收费 防水 袋 一定 要 在 外面 买 同样 的 防水 袋 外面 两个 里面 不 讲价 所谓 的 海水浴场 不能 游泳 画 了 个 小方块 给 人群 冲浪 人挤 人 很 夸张 海水 很脏 还有 个 咸水 泳池 你 去 看 了 就 知道 有多脏 了 上面 全是 漂浮物 没 人 打理 海盗船 那些 游乐 设施 另 收费 一个 人 总之 坑爹 就是 了	__label__2
没 特色 人超 多 好 无聊 拒绝 再 来	__label__2
墓 上 是 铁 盖子 很多 人 又 摸 又 敲 的 其实 真 没 啥 可 看 的	__label__2
超级 不满	__label__1
可能 因为 去 的 时候 比较 晚 而且 是 五月份 水 比较 少 所以 感觉 还 没有 箭竹 海 瀑布 好看	__label__1
我 所 见 过 的 最烂 的 沙滩 全是 大石头	__label__2
长白山 姓孔 的 师傅 电话 真的 很 黑 哦 大家 坐车 要 注意 哦	__label__1
坑到 家 的 景点 五十块 钱 的 门票 进去 三个 小 展厅 展厅 里 的 设备 大多 还是 坏 的 展厅 外全 是 牦牛 在 吃 草	__label__1
住宿 好贵 第二天 一早 过 普陀山 没 办法 海鲜 很 新鲜 很 好吃 也 不算 贵 [ 疲惫 ] [ 疲惫 ] [ 疲惫 ]	__label__2
景区 周围 有点 乱 门票 贵 向导 少	__label__2
分别 于 日 乘坐 火车 来 的	__label__2
来 之前 看 马蜂窝 上 很多 网友 都 说 天门山 比 张家界 森林公园 好 去 完 张家界 森林公园 之后 非常 期待 天门山 但是 结果 让 我 很 失望 玻璃 栈道 的 玻璃 已经 被 磨花 了 而且 玻璃 栈道 很 短 没 几步 就 走 完 了 天门 山上 很多 卫生间 都 关闭 了 不让 用 就算 是 淡季 也 不能 这样 呀 张家界 森林公园 内 的 厕所 虽然 也 停水 但是 人家 的 厕所 至少 还是 开门 的 还有 就是 天 门洞 和 天梯 也 是 关闭 的 天门山 标志性 的 景点 都 看 不了 相比 张家界 森林公园 的 门票 天门山 这 的 门票 真是 不值 全当 是 做 趟 缆车 了	__label__2
玩 不到 几个 项目 的	__label__2
景点 没什么 说 的 十多年 前去 过 感觉 建筑 保存 完好 历史 人文 气息 浓厚 才 会 再次 去 游览 但是 这回 体验 感觉 非常 差 百度 导航 的 停车场 但是 我们 的 被 当地人 为 地 引导 去 了 一个 非常 远 的 临时 停车场 无人 管理 的 黄土坡 随意 到处 停 停车 以后 走 了 很 长时间 到 路口 被 告知 去 游览 相府 很远 有 三 公里 在 百度 旅游 买 的 门票 不 包括 电瓶车 需要 另外 买 一个 人 买票 以后 一辆车 来 呼啦 一群 人 围上去 抢 座位 现场 秩序 婚礼 无人 引导 很 危险 坐 上 电瓶车 被拉到 一个 叫 相府 庄园 的 地方 其实 就是 当地 村新修 的 几个 温室 大棚 根本 不是 皇城 相府 放着 广告牌 也 是 这个 村 又 办 药厂 又 办 汽车厂 游客 花钱 是 来看 你 广告 的 吗 在 大棚 游览 正好 中午 路过 相府 宾馆	__label__1
忽悠 大大的 忽悠 看 网站 上 介绍 的 如何 精彩 项目 丰富 决定 带 孩子 去 体验 一回 南方 滑雪 的 感觉 说实话 我 不在乎 欢乐谷 的 服务 有 多 好 设施 有 多么 丰富 因为 对 旅游景点 那些 猫腻 太 熟悉 了 但是 你 不能 骗人 啊 在 售票处 买 门票 的 时候 售票员 就 强烈要求 我 把 携程网 定 的 家庭 套票 退掉 买 他们 的 门票 元 说 家庭 套票 是 不 包括 滑雪 的 只能 玩 其他 项目 我 说 我们 孩子 小 就 玩玩 滑圈 儿童 儿童 就 可以 了 答复 是 不行 必须 买 滑雪 票 乘坐 缆车 上 到 山顶 你 猜 怎么 的 什么 儿童 项目 冰雪 世界 只有 滑雪 一项 那些 介绍 的 花天酒地 的 项目 根本 就 没有 忍 了 玩吧 接着 那些 所谓 的 教练 就 三五成群 的 缠 着 你 一个 教练 教 你 滑雪 的 基本 动作 一个 人 我们 提出 说 你们 一个 教练 教教 孩子 我们 大人 顺便 学学 呗 答复 是 我们 游客 的 钱 就 那么 好赚 啊 好多 游客 还是 学生 太 不人道 了 我 很 讨厌 这样 没有 人情味 的 旅游景点 一味 的 赚钱 让 人 心寒 无比 尤其 是 这种 把 教练 内容 承包 出去 的 做法 这次 的 旅行 让 我 感到 失望 透 了 应该 不会 再 去 说 说 上海 七莘 滑雪场 的 做法 雪 场内 有 若干名 教练员 无偿 地 讲解 滑雪 动作 亲切 有 耐心 几年 前 我 还 去过 瑞士 铁 力士 雪山 在 那里 有 专门 的 儿童 玩雪区 一票 到底 不会 二次 三次 消费 而且 还有 休息区 浙东 第一 尖太差 了	__label__2
在 天安门广场 绕 着 纪念堂 排 了 两 小时 的 队 进入 瞄 了 两眼 就 出来 了	__label__2
天门山 是 一个 独立 的 景区 位于 张家界 市区 距离 火车站 很近 步行 十几分钟 就 可以 到达 索道 站 天门山 其实 半天 时间 就够 了 除了 爬 到 天 门洞 上 天梯 的 级 台阶 以外 基本 不 需要 耗费 什么 体力 一路上 都 是 索道 、 巴士 、 电梯 基本上 可以 直接 到达 山顶 了 这 也 是 我 个人 比较 吐槽 的 地方 没 的 选择 不能 徒步 爬山 只能 坐 索道 和 电梯 至于 玻璃 栈道 看 个人 喜好 吧 其实 距离 很 短 我 是 完全 无感	__label__2
发觉 古城 都 是 一个样 人为 的 痕迹 太重 了	__label__2
门口 售票 窗口 贴 有 国家 的 优惠政策 可是 售票员 说 从来不 知道 看来 国家 的 优惠政策 如同 摆设 了 希望 能够 好好 治理 了 我们 在 云水洞 的 门口 买票	__label__1
‘ 不须 此行	__label__1
鄂尔多斯 没什么 值得 去 的 地方 所谓 成陵 也 美 什么 文物古迹 风景 也 是 一般 还有 大家 千万别 去 那个 私人 修建 的 所谓 什么 成陵 景区 那 门票 里面 都 是 些 后来 建造 的 场景 与 雕像 真的 不 值得 去 如果说 成陵 有点 好 就是 周边 有 一片 草场 还 行 蓝天白云 的 但是 千万 不要 在 蒙古包 里 吃饭 我们 几个 人 吃 了 个 烤全羊 花 了 多 真的 不值	__label__2
现在 我 不 知道 具体 改造 成 什么 样子 但是 我 年 左右 去 的 时候 场面 确实 不怎么样 泉水 边 铺就 的 水泥 地面 画上 了 * 米 的 小格子 原来 是 专门 给 疗养 的 人 躺 着 做 泥巴 、 泉水 洗浴 的 真心 的 不 推荐 啊	__label__2
排队 排队 排队 没有 不 排队 的	__label__2
景色 独特 设施 完整 服务 方便 期待 再行	__label__1
一般 动物 不 多 景区 管理 也 不 太太 好	__label__2
有 不错 的 景致 可是 太过 雷同	__label__2
环 青海湖 的 第一站 说实话 没什么 可看 的 草坡 上 全屎	__label__2
没什么 感觉	__label__1
清明 人 巨多 上山 三个 半小时 下山 用 了 五个 半小时 等 索道 等 了 俩 小时 明显 接待 力 不行	__label__1
可能 是 去 的 季节 不 对 什么 都 没有	__label__1
风景 很 美 值得 去 但 排队 时间 太 长 我们 点到 景点 点 下山 排队 就近 个 小时 再 美的 风景 也 无 心情 欣赏 且 停车场 收费 太宰 人	__label__2
看个 观音 还 得 另外 买票 走个 寺庙 还 得 买票 奶奶 的	__label__1
没去 的 时候 还是 满 期待 的 毕竟 也 是 个 几 的 风景区 不 过去 了 之后 只想 说 生态 真的 是 很 差 所谓 的 湿地 就是 芦苇 小河 吧 也 没什么 鸟 真的 还是 国外 的 湿地 公园 生态 好 很多	__label__1
没什么 意思 就 爬山 一小 会 然后 看看 富春江 风景 还 不如 一般 好点 的 公园 门票 大 一小 元 + 元 停车费 没意思	__label__1
这个 博物馆 就是 介绍 一些 武夷山 的 文化 没意思 可以 不去 看	__label__2
这次 去 雁荡山 的 感受 是 比较 失望 的 景点 分散 各个 景点 都 要 收取 停车费 大龙湫 、 灵峰 、 灵岩 停车费 都 是 元方洞 景区 停车费 变成 元 理由 竟是 门票 比前 三个 景区 要 便宜 另外 几 大 景区 中当 属 灵峰 最 没意思 且不论 灵峰 景区 分 白天 和 晚上 收费 我们 选择 的 是 灵峰 夜景 进去 之后 景区 一片 漆黑 所谓 夜景 不过 是 绕 着 里面 转 一圈 然后 望 着 山中 石头 意淫 出 它 像 什么 而已 总结 不 推荐 去 雁荡山 旅行	__label__2
北京 人 晨练 的 地方 游客 不 推荐 樱花节 的 时候 人多到 走不动	__label__2
为什么 放着 故宫 不去 非要 到 这里 呢	__label__1
就是 一般 的 建筑 没有 什么 特色	__label__2
温州 乐园 人太多 了 有 做 过山车 的	__label__2
垃圾 景区 乱收费 持证 都 不认	__label__1
东栅多 旅游团 全是 人 反而 是 西栅人 特别 少 比较 安静 如果 想 去 东栅 看看 的话 只能 在 第一批 旅游团 到达 之前 或者 最后 一批 旅游团 离开 之后	__label__2
好久没 下雨 了 水流 稀少 但是 很 清澈 水里 的 锦鲤 都 好 大 山路 还算 好 走来 一次 足以	__label__2
温泉 项目 太 少	__label__2
本来 想 去 看着 评论 跟 图片 醉 了 果断 放弃 这种 村落 南方 到处 都 是 独特 民风 哈哈 殊不知 你 四合院 人均 几 平米 的 地方 还 不如 这 村落 呢 中国 人 都 是 打肿脸充胖子 出去 充 大款 不宰 你 宰 谁	__label__1
很 失望 光有 美名 没有 美景 感觉 管理 也 不好	__label__2
印象 不 乐观	__label__2
海水 是 黄色 的 虽然 海边 有 很多 海鲜 排挡 但是 宰客 太 厉害 节假日 还 人 特多 停个 车绕 了 古镇 两圈 不 推荐	__label__2
很小 的 地方 是 周围 人 散步 的 不用 特意 去	__label__2
没 啥意思 不 建议 去 名气 大 而已 金钱 堆砌 的 一个 钢结构	__label__2
真的 像 网上 说 的 一样 商业化 太 严重 想 看 北京 胡同 文化 的话 还是 建议 去 史家 胡同 或者 随便 找 一条 北京 小巷子 就 能 看到 原汁原味 的 老 北京 街里 有 文宇 奶酪 店 很 出名 奶酪 不像 传统 西方 奶酪 像是 很稀 的 一种 老 酸奶 风味 独特 建议 尝 一下	__label__2
没用过 还 没有 取消 功能	__label__1
大家 千万 不要 再 去 了 人太多 了 谁 去 谁 后悔 每个 项目 都 得 排队 个 小时 才能 玩	__label__1
地方 很小 都 是 人 而且 卫生 情况 不是 很 好 空气 不是 很 流通 拥挤 并且 品种 太少 的 性价比 并 不是 很 高	__label__1
并 没有 什卵用	__label__1
各种 蛇   就是 个 蛇类 动物园 好 怕怕	__label__2
夫子庙 小吃 慕名 而 去 又 贵 又 难吃 真的 很 难吃	__label__1
原来 是 一家 专科 院校 学生 品质 参差不齐 后来 貌似 因为 滨江 校区 建成 后 也 就 年 左右 学校 各个 专业 、 年级 都 陆续 搬 到 那边 作为 总部 了 于是 这里 越发 显得 荒凉 可能 因为 建校 比较 早 的 缘故 吧 加上 现在 的 地段 划分 校园 面积 很小 格局 呈 一 字型 从 传达室 大门 进去 后 正中间 这幢 楼 是 教学楼 楼层 不高 大概 也 就 层 左右 现在 看起来 有点 破败 大门 往右 经过 一个 小 花园 再就是 一个 副 停车场 最 里面 是 操场 大门 往 左 原来 是 个 篮球场 后来 可能 因为 设备 跟不上 加上 学生 也 越来越少 了 就 直接 开放 成 了 停车场 了 再 往里 的 两侧 一边 是 寝室 楼 一边 是 食堂 也 都 是 最低 配 的 布置 寝室 楼 的 朝南 部分 朝着 德胜路 大 马路边 上 低 楼层 的 房间 能 被 路过 的 行人 、 车辆 看到 高 楼层 的 房间 能 被 上方 的 高 架上 经过 的 车辆 看到 整幢 楼 无 私密 现在 的 浙江 商业职业 技术 学院 ( 德胜 校区 ) 貌似 已经 完全 退出 了 高考 的 专线 学校 接收 的 都 是 成人 院校 的 学生 然后 大部分 双休日 倒 是 都 很 活跃 经常 有 各种 社会性 考试 在 这里 座位 考场 虽然 看 情况 也 没有 要 拆 的 迹象 不过 倒 是 方便 了 很多 社会 考生 毕竟 德胜 也 算是 市中心 不远 的 地方 了 总要 比 动辄 要 过江 的 滨江 、 萧山 或是 要 走 完整 条德胜 快速路 到 下沙 来 的 近 的 多 也 多少 发挥 着 它 的 用武之地 吧	__label__2
只能 说 这 是 一座 山 完全 的 都 是 人工 开发 当地人 管理 的 政府 不 介入 设施 很差	__label__2
去 的 次数 太多 了 都 懒 的 写 了 不 去 了	__label__2
非常 坑 千万 不要 去 每个 岛 都 有 收费 项目	__label__2
坑爹 的 地方 强烈建议 后来 人 不要 从 森林公园 大门 进入 景区 进去 之后 几乎 没什么 景色 可以 看 路程 还 非常 长 就 一条 小溪 刚 从 赤水 回来 的 我 对 它 根本 不 感冒 一路 走 下来 累坏 了 严重 影响 接下来 旅途 的 心情 和 状态	__label__1
门票价格 超级 贵 没 啥 看头 爬山 小时 缆车 只 坐 到 分钟 的 路程 然后 都 得 已 爬 会 很 冷路 很 滑 这个 景区 里面 买 的 东西 都 超级 贵	__label__1
别来 好 坑 过个 吊桥 收块 骗 死 人	__label__1
作为 全 中国 人民 的 北大 已经 完全 抛弃 了 兼容并包 的 思想 不让 游客 进入 这 一条 简直 值 一百个 差评 现在 的 一塔 湖图 景色 虽然 还 在 却 完全 没有 了 第一 学府 的 气度 与 沉淀 满是 浮躁 之气	__label__1
感觉 很 是 不好 也许 去 的 时间 不 对	__label__2
本身 景色 还 不错 就是 门票 贵人 为 设置 一些 诱导 消费 不爽	__label__2
武士 驯马 是 在 天子 阁 后面 右手边 往里 走 的 一个 观景台 天子 阁 后面 左侧 则 是 下山 的 台阶 个人 觉得 武士 驯马 可以 选择 去 或 不 去 因为 就是 一个 观景 的 平台 我们 当时 就 没 去	__label__2
沈家门 大排档 价格 超贵 举个 例子 最 便宜 的 海 鲈鱼 都 要 七 、 八十 元 一斤 其他 的 更 不要 说 在 天津 鲜海 鲈鱼 只要 十几元 ( 大型超市 后来 我们 到 沈家门 市区 饭馆 去 吃 了 结果 便宜 很多 螃蟹 、 鱼 、 小 海鲜 都 是 活 的 都 吃 到 了 两 人才 花 了 元年 秋去 的 舟山	__label__1
对于 普通 游客 来说 真心 没 啥 去 头	__label__2
路过 就 好 不是 必须 要 去 的 一路上 景致 都 差不多	__label__2
深深 感受 到 当地人 的 热情	__label__2
陈旧 的 主题乐园	__label__2
绿树成荫 悠悠 长长 是 自然景观 与 人文景观 结合 的 最 美妙 的 地方	__label__2
就是 小吃 一条街 本想 晚饭 这里 解决 的 没想到 大排档 里 要 排 很 长队 问得 来说 这里 的 物价 可比 北京机场 但 小吃 真心 难吃 买 了 一个 当地 包子 和 一杯 酸梅汤 尝 了 一点 就 丢 垃圾箱 了 下次 不会 再 去 了	__label__1
去过 差 的 没 去过 这么 差 的	__label__2
这个 可以 省略 掉 景色 没有 有 的 不如人意	__label__2
进入 之后 没有 太 多 感觉 有 一排 仿古 建筑 估计 是 为 旅游 搞 的	__label__2
五台山 静心 斋价 贵物 不好 就是 门面 大 不 推荐 五峰 宾馆 五星 不符 做菜 放盐 象放米 难以 下咽 浪费 钱 浪费 东西 罪过 罪过	__label__1
登封 附近 有家 天然居 酒店 是 家 黑店 年 月 号 入住 号 退房 时不退 押金 报警 登封 少林寺 景区 派出所 接警 警察 说 处理 需要 我们 住 下 随叫随到 需要 多长时间 不 一定 我 真是 无语 了 我们 是 游客 不是 来 定居 的 警察 说 想 快点 解决 只能 和解 而 和解 的 办法 就是 游客 掏钱 在 警察 的 调节 下 我 被 讹 元 才 可以 离开 警察 已经 成 了 黑店 的 帮凶 大家 千万 小心	__label__1
说句 不好 听 的 真的 就是 两条 大河 而已 最多 就 值 块钱 门票 真的 好 没意思 门票 死贵 一点 都 不值 估计 下次 免 门票 都 懒得 去 了	__label__1
天柱 晴雪 只能 算是 天柱山 的 一个 小 景点 而已	__label__2
不 喜欢 不 喜欢 不 喜欢 · · · · · · · · · · · · · · · · · · · · · · · · · · · · · ·	__label__2
我们 一行 是 月 日 到 的 鸟岛 门票 是 一百元 加 三十元 景区 内 的 一次 电瓶车 和 一个 往返 大巴 的 交通费 合计 元 的 费用 看 了 两个 景点 一个 是 蛋岛 一个 是 鸬鹚 岛 所谓 蛋岛 就是 进 一个 长廊 两边 挂 了 一些 摄影 作品 到 了 长廊 尽头 隔 着 玻璃 看 外面 的 乱石滩 而 我们 去 得 时候 石滩 上 什么 都 没有 哪怕 一个 蛋 都 没有 第二个 景点 是 鸬鹚 岛 就 看到 一块 礁石 上 歇 着 许多 鸬鹚 仅此而已 我 没有 看过 鸟岛 的 盛况 也 不 了解 什么 鸟类 的 生活 习性 我 只是 就 我 看到 的 情况 做 一个 描述 我 觉得 鸟岛 看到 的 东西 总计 一个 小时 十分钟 的 游览 时间 对不起 元 门票 和 我们 大老远 地 跑 去 慕名 游览 景点 这种 对 游客 不负责任 只管 收钱 的 行为 促使 我 一定 要 写 下来 招告 大家 不要 上当 用脚 投票 让 这样 的 景点 受到 惩罚	__label__1
不 知道 那么 高 的 评价 那来 的	__label__1
与 景区 相差 甚远 指示 不清 多 走 好多 路	__label__2
昔日 繁华 已 被 历史 淹没 在 其 车轮 之下	__label__2
不好玩 一点 特色 都 没有 这种 景区 直接 应该 免费	__label__1
中国 第一 秋景 真的 很美 只 可惜 景区 的 运营 管理 不能 更 垃圾 禁止 社会 车辆 进入 强制 将 游客 聚集 起来 排队 排队 无尽 的 排队 老子 不远万里 来 新疆 不是 来 被 排队 的	__label__1
纵想 百年 汽车 文化 体验 现代 工业 传祺	__label__1
失败 的 旅行	__label__2
八达岭 现在 不行 了 去 玩 堵车 不说 景区 服务 不好 宰 游客 想 看 长城 可以 去 慕田峪	__label__2
感觉 孤山 没 啥 特点 很 无聊 浪费时间	__label__2
要不是 山下 晚上 实在 没什么 可 做 的 事 也 不会 去 看 这个 没什么 可看 的 还 有点 远 不 建议 去	__label__2
一般般 去过 最差 的 景点 定 的 门票 没有 退完 特别 垃圾	__label__1
周庄 只能 说 是 和 我 想象 中 的 差太多 了 水 很 浑 这点 算 小事 了 整个 镇子 的 商业化 太 严重 每条 路 的 两边 都 是 商贩 没有 别的 就 像 菜市场 一样 如果 真的 有 什么 很 好 的 很 值得 买 的 特产 也好 但是 这么 的 没有 啊 除了 吃 的 以外 我 觉得 那些 小商品 我 在 沈阳 都 能 买 到 我 拍 的 照片 和 我 所处 的 环境 并 不 相符	__label__2
不错 挺 美的	__label__1
殷墟 和 殷墟 博物院 在 一个 院子 里 就 有 几个 地基 文物保护 的 非常 不好 车马坑 都 长草 了 门票 元 十分钟 就 逛 完 了 不 值得 反正 我 是 很 失望 了 如果 很 想 去 的话 售票 结束 后 门口 会 有 村里人 带 你 从 后面 绕 进去 不过 博物院 进不去 每人 二十 然后 大摇大摆 的 从 正门 出来 就 可以 了	__label__2
就是 交通 不太 方便 票 买 了 都 没有 去	__label__2
风景 不错 温度 也 比较 合适 服务 太差 太差 太差 没有 明显 的 地标 索道 也 特别 烂 最 重要 的 是 下山 的 时候 买 车票 的 工作人员 不说 清楚 车到 哪里 导致 我们 换 了 两次 车 还 把 我们 越拉越 远车 是 小面包 没有 安全带 从 山上 下来 的 时候 开 的 超快 跟 过山车 一样 总之 不会 再来 差评	__label__1
地方 太小 了 没什么 感觉	__label__2
之前 觉得 武夷山 名气 还 不错 就 春节 过来 看看 这边 实在 有点 失望 首页 景区 外围 住宿 条件 太 差 酒店 少 还 比较 混乱 通过 平台 预定 的 很多 到 了 以后 才 说 没房 奇货可居 比 武陵源 等 地方 差太多 了 作为 一个 沿海 省份 不 应该 啊 其实 景区 管理混乱 网络 取票 机器 太 少 排队 太久 每个	__label__2
商业化 严重 没 了 古朴 老街 的 韵味 在 酒吧街 门口 看到 了 半个 胳膊 长 的 大 耗子 整个 旅行 都 不好 了	__label__2
丽江 古城 是 丽江市 的 一处 旅游景点 又名 & ; 大研 古镇 & ; 坐落 在 云南省 丽江市 大研镇 地理坐标 为 东经 ° ′ 北纬 ° ′ 海拔 余米 是 一座 风景秀丽 历史悠久 和 文化 灿烂 的 名城 也 是 中国 罕见 的 保存 相当 完好 的 少数民族 古镇 丽江 古城 是 第二批 被 批准 的 中国 历史 文化名城 之一 也 是 中国 仅 有 的 以 整座 古城 申报 世界 文化遗产 获得成功 的 两座 古城 之一 ( 另 一座 为 山西 平遥 古城 ) 丽江 古城 有着 绚丽多彩 的 地方 民族 习俗 和 娱乐活动 纳西 古乐 、 东巴 仪式 、 占卜 文化 、 古镇 酒吧 以及 纳西族 火把节 等 别具一格 丽江 古城 充分体现 了 中国 古代 城市 建设 的 成就 是 中国 民居 中 具有 鲜明 特色 和 风格 的 类型 之一	__label__2
别去	__label__1
实在 不 懂 有 什么 意思 一条街 挤满 了 人 一个 牌子 的 店开 好几家 在 常见 不过 了 还 没 特色	__label__1
差评 无极限	__label__2
以为 淡季 来 的 没想到 定期 有 当地 的 免费 票 那 人太多 了 其实 谁 也 没 省钱 光 排队 了 倒 搭 钱 您 也 得 后悔 到 景点 什么 都 没干 进排 小时 队 出来 排个 小时 路上 有伙 打 起来 的 都 是因为 太挤 建议 景点 分批 搞 免费 人多 对 花钱 的 太 不 公平 住 山上 多 一个 间 下山 今天 你 就 白来	__label__2
东南 湖区 只 包含 门票 不 包含 船票 !	__label__1
双 阳湖 不产鱼 自然 就 没有 名气 偏远 而 没落	__label__1
年月日 除了 特大号 毛 爷爷 头像 以外 就是 倚 在 湘江 边 吹 吹 凉风 了 其它 没什么 好看 的 刚 和 贱 康吐槽 这 景点 还 五星级 然后 它 就 被 摘牌 了 他们 说 我 嘴 有毒 ( ￣ ▽ ￣ ) ( ￣ ▽ ￣ )	__label__2
来 厦门 必须 去 太 商业 太多人 教堂 上 、 对 的 新人 拍 婚纱照 食街 太 邋遢 再也 不去 第二次	__label__2
没 进去 门票 有点 贵 门口 看 了 看	__label__2
来 之前 专门 做 了 功课 查 路线 需要 线 因为 住 动物园 附近 早晨 点多 叫醒 孩子 和 老婆 收拾 东西 去 赶 地铁 到 北京北站 时 : 左右 立刻 排队 准备 进站 当 我们 前面 有 左右 人时 很 不幸 通知 列车 已经 满员 需要 等查 了 一下 : 泪奔 啊 好 吧 我 等 第一趟 开走 大约 一会 检票 进站 找到 位子 之后 发现 没有 人 坐 有人 直接 排队 了 好 吧 我们 也 排 吧 后面 越 拍 越 多 老人 、 小孩 都 挤 着 往后 一看 人 确实 不少 苦苦 等待 近 : 时 开始 放行 了 前面 的 一窝蜂 冲 了 进去 我 进去 一看 火车 好远 啊 拎 着 包 牵 着 孩子 手 一顿 猛 跑 天 哪 跟 打仗 一样 好 可怕 冲 上车 到处 找 座位 稍晚 一些 就 没 坐 了 坐下 后 孩子 说 爸爸 我 心跳 的 好 快 啊 一路 还有 上车 的 全是 站 着 的 再 来说 说 返程 提前 一个半 小时 赶到 火车站 全面 近人 还 比较 乐观 慢慢 人 越来越 多 一圈 一圈 的 等 车站 着 腿 好 累 放行 后 又 是 一顿 猛跑 脑中 一个 想法 跑 到 最 前面 就 可以 了 好 了 到 一个 地方 排好队 前名 看看 就 能 乌 压压 一片 人 感觉 还 挺 好 一会 乘务员 说 了 一句 让 我 吐血 的话 基本 第一节 车厢 有座 其他 始发站 就 满 了 果然 上车 傻眼 一路 站 回来 这 一路 下来 脚疼 腿疼 来回 坐车 给 人 的 体验 太差 了 看到 车上 的 老人 、 小孩 百感交集 试问 相关 管理 部门 你们 这是 什么 作为 明 知道 会 有 很多 人 为什么 不 加开 列车 什么 的 深感 无奈 特别 是 刚 看 网易 说 晚上 还有 很多 人 在 八达岭 车站 心里 更 不是 滋味	__label__2
不值 票价	__label__2
有 故事 的 地方 风景 一般 去不去 无所谓 私人 开 的 小 景点	__label__2
乌镇 是 江南 六大 古镇 之一 乌镇 东栅和西 栅 成年 联票 块钱 当天 有效 东栅 相比 西栅 逊色 一点 就 一条 河流 小时 + 拍照 基本 就 能 逛 完 然后 出 景区 门外 有 客车 凭 联票 可 免费送 去 西栅 景区 那边	__label__2
品种 太 少 太普通 去 了 真的 浪费 钱 海洋馆 没有 鲨鱼 竟然 有 一堆 金鱼 也 是 够 了 海底隧道 材质 不好 会 让 人 觉得 非常 眩晕	__label__2
景点 乱糟糟 的 旅游 环境 很 不好 时刻 有种 被 宰 的 感觉	__label__2
还 不错 吧 不过 动物 乱套 不怎么 滴 我 觉得 有点 规划 更好	__label__1
票价 没有 便宜 跟 现场 买 一样 价格 还要 提前 一天 订 没有 什么 好处	__label__2
相 比较 之前 去过 的 查济 宏村 呈 坎西递 这个 徽州 古城 歙县 古城 是 最 不 值得 去 的 虽然 蚂蜂 窝 提到 中国 歙县 古城 还 与 四川 阆中 、 云南 丽江 、 山西 平遥 并 称为 四大 古城 事实 是 完全 不能 和 我 之前 去 的 山西 平遥 古城 相比 里面 犹如 夫子庙 还有 各种 商业 专卖店 面 很多 坑亏 花元 门票 看 这些 同行 朋友 怒称 花元 看 美特斯 邦 威 等 专卖店	__label__2
本篇 决定 采用 欲 抑先扬 的 方法 科科 微笑 脸 另 本篇 纯粹 站 在 大学生 穷游 屌丝 没钱 党 角度 不喜 勿 看 靠着 各种 综艺节目 古北 水镇 出现 在 了 大众 视线 中 这里 风景优美 有 北方 乌镇 称号 适合 拍照 发票 圈 适合 图 适合 装 贝塔 你们 可 随意 感受一下 我加 了 滤镜 的 照骗 实话 说 这里 风景 确实 不错 感谢 高 票价 高 收费 游客 并不多 垃圾 也 不 多 干净 整洁 建筑风格 也 的确 配得 上 北方 乌镇 的 称号 古色古香 豪们 也 可以 随便 找个 靠近 小桥流水 的 地方 吹 着 小风 看着 小景 喝 着 ☕ ️ 真是 惬意 又 舒适 嗷 然而 然而 尼玛 在 这 无奈 陪 着 老妈 逛 了 一整天 之后 我 真是 心中 千万匹 草泥马 呼啸而过 我 真是 从来 没见 过 这么 坑人 这么 无聊 的 景点 真是 逼 着 我 吐 槽 票贵 就 不 说 了 为 毛 司马台长城 还要 跟 它 联合 捆绑 销售 啊 确实 很多 人 心中 都 有 一个 古镇 梦 古朴 的 镇子 自然 美景 厚重 历史 悠悠 生活 自由 而 又 不受 打扰 的确 国内 很多 古镇 面临 着 商业化 严重 越来越 趋同 的 问题 熙熙攘攘 的 人群 嘈杂 的 闹市 这些 都 打破 了 人们 心中 的 美好 想象 然而 在我看来 那些 古镇 起码 保留 着 真实 的 人气 — 人们 生活 的 气息 起码 我 可以 感受 到 生活 在 那块 土地 上 的 人民 的 痕迹 — 现在 的 或是 曾经 的 然鹅 古北 水镇 我 只能 呵呵 贵贵贵 的 后果 就是 人迹 稀少 商家 遍布 可 开门 的 却 没 几家 这里 有着 浓重 的 人为 痕迹 一切 的 古朴 、 历史 都 渗透 着 现代 商业 刻意 雕琢 的 痕迹 建 这个 古镇 的 企业 无疑 下 了 血本 可惜 投入 与 产出 不 成正比 我 唯一 能 感受 到 的 只有 一个 字假 我 甚至 在 怀疑 这个 景点 的 意义 我 只能 说 这里 是 摆 拍 伪 高大 上 的 好去处 只是 真的 不太 适合 我	__label__2
处处 坑钱 什么 世界 最牛 天梯 就 一个 电梯 而已 块钱 一分 多钟 看 那 几条 石柱 比去 抢 还 赚钱 还 不如 我 步行 高兴	__label__1
山上 服务质量 太差 乱 要价 平常 多 住宿 要 到 还 不 给 开 收据 什么 都 要钱 太 失望 啦 这 景区 还 不如 别的 景区 纯宰人	__label__1
不 值得 去 不 值得 去 不 值得 去	__label__1
纪念 孔夫子 的 地方 里面 完全 可以 不 进去 门口 留个 影 即可	__label__2
打车 花 了 将近 才 到 这 但是 却 没有 修好	__label__2
太 黑暗 了 门票 太贵 太贵 性价比 超级 低	__label__2
断桥 人难断 过度 的 商业 气息 使得 断桥 难以 回复 昔日 的 清冷	__label__2
元旦 来 的 跟 户外 大巴 一起 进 景区 就 很窄 一条 路 门票 上山 的 车 还要 索道 玻璃 栈道 说实话 就是 一个 山 并 没有 什么 景点 玻璃 栈道 往下 看 高度 只有 米左右 而且 看 照片 可以 看到 全是 垃圾 三点 准备 回去 的 但是 说 路边 被车 堵住 了 让 我们 等 车主 下来 景区 方说 已经 去 找 人 了 结果 等 了 两个 多 小时 也 并 没有 下来 景区 领导 电话 打去 也 说 马上 就 来 也 一直 没 见到 人 完全 没有 处理 方案	__label__1
网络 买 的 票 没有 使用 显示 已经 消费 退 也 退 不了 一个月 了 一点 音讯 也 没有 对美团 我 是 大写 的 服	__label__1
完全 都 是 人造 的 景观 没什么 意思 不 推荐	__label__2
有点 失望 里面 其实 含金量 的 藏书 不 多	__label__2
不 值不值 这个 票价	__label__1
也 就 人造 景区	__label__2
第一次 去 觉得 很 新奇 可是 逛 完 了 就 觉得 不 咋 地 很快 就 能 逛 完 并 不 推荐	__label__2
真 无聊 一个 膀子 用 铁丝 绑 着	__label__2
因为 不巧 赶上 阴天 结果 山上 下雨 了 所有 景色 看不见 一片 雾茫茫 景区 标识 不合理 走路 走 了 很多 弯路 手机信号 时有时无 所以 导航 不准 从 金沙 索道 绕 了 远路 反正 走 了 很 久 才 到 三 清宫 景区 没有 考虑 到 自由 行 的 散客 吗 没有 导游 路标 也 不清不楚 从 西海岸 去 三 清宫 一路	__label__1
门票 太贵 超过 北京 大部分 景区 、 没 啥 看点 被 黑车 司机 骗 到 这儿 的 认栽	__label__1
地坛公园 又称 方泽坛 在 中国 北京 安定门 外是 明世宗 以后 明清两代 皇帝 每年 夏至 祭祀 土地 神 的 地方 地坛 始建 于 明代 嘉靖 九年 公元 年	__label__2
如果 他 不是 水立方 他 也 就是 什么 都 不是 了	__label__2
如果 有朝一日 能 发掘出来 就 好 了 现在 只能靠 脑补	__label__2
什么 破 介绍 我 在 地图 上 一 晚上 都 没 找到	__label__1
看 完 评论 真心 不想 去 了 有人 在 景区 外 乱收 停车费 好像 不敢 去 了 算了 换 地方 吧	__label__1
不值 这么 多钱	__label__2
主要 是 价格 太贵 一共 一 小时 就 能 游玩 的 地方 要元 风景 也 没 比 别的 地方 好	__label__2
百龙 天梯 是从 金鞭 溪 进去 上到 袁家界 景区 的 一个 交通 方式 两外 还有 一种 方式 就是 金鞭 溪 景区 走 乱窜 坡 上 到 袁家界 景区 个人 认为 有 体力 的 人 还是 走 一下 吧 从 乱窜 坡 上山 因为 百龙 天梯 真的 就 只是 为了 节省 体力 而造 的 并 不能 看到 和 其他 地方 不 一样 的 风景 而且 还 费钱 、 费时间 排队 从百龙 天梯 和 爬 乱窜 坡 上山 耗费 的 时间 是 差不多 的 只能 说 看 个人 了 在 电梯 里面 也 没什么 好看 的 因为 在 其他 地方 都 可以 看到 一样 的 景色 真的 没有 必要	__label__2
不 值得 专门 去	__label__2
非常 坑人 的 门票 景区 是 免费 的 收费 的 里面 都 是 模型 和 图片 无语 的 一次	__label__1
没 啥意思 比 横店 差远了	__label__2
门票价格 还 行 就是 景区 感觉 没 必要 买 门票	__label__2
之前 没有 任何 准备 没 去 大龙湫 这里 没什么 特色	__label__2
人太多山 也 不 高 不好玩	__label__1
一个 比较 垃圾 的 地方 三十块 大 门票 和 三十块 的 外 蒲山 门票 很脏 连 沙滩 都 没有 不 知道 能 看 什么	__label__1
人多 排队 三个 小时 玩 一个 项目	__label__2
说真的 就是 花 了 几百块 坐车 转 了 一圈 有点 让 我 失望	__label__2
老虎滩 实在 太乱 了 服务 人员 对 游客 态度 极其 恶劣 一下 车 就 有 各种 倒 蹬 票 的 比 正常 便宜 这些 人 与 买 团体票 的 窗口 相互 勾结 其中 很 有 猫腻 他们 忽悠 我 与 爸妈 购买 什么 极地 飞跃 馆 结果 我 爸妈 以上 根本 不能 玩 我 的 票 上 写 的 是 团体票 于是 我 去 团体票 里 咨询服务 人员 对 我 爱答不理 当 我 说 清 事情 后 对 我 大声 说 跟 她 有 什么 关系 就 不会 好好 说话 不如 狗 更加 恶劣 的 是 她 很 大声 的 把 我 往外 赶 说 我 没 看见 游客止步 瞎 吗 我 愿意 进来 吗 你们 这里 管理混乱 我 才 不得已 进来 咨询 这种 态度 真是太 恶心 了 里面 的 东西 已经 几年 都 一样 了 辣鸡 啊 辣鸡 大连 旅游业 这个 德行 真的 没有 必要 来 大连 玩 真的 十分 混乱	__label__1
每家店 卖 的 东西 都 差不多 没什么 可看 的 没 特色	__label__2
车子 一点 不 豪华 不值	__label__2
个人 不太 喜欢 红色 旅游景点 这次 被 拉 着 去 了 井冈山 最 浪费时间 的 就是 这个 故居 了 一间 房子 一张 床 没什么 好看	__label__2
云台 花园 后面 的 植物园 真 不错呀	__label__2
外围 的 商业 服务 与 餐饮 各种 被 坑 不是 很 开心	__label__2
景色 不错 北京 周边 有 很多 这样 类似 的 景色 感觉 不足为怪 了 只是 长期 生活 在 城市 里 平时 周末 作为 放松 换个 环境 可以 去 一下 不过 真心 没什么 可玩 的 就是 一 公园 里面 各种 贵 六个 人 的 电瓶 船块 一 小时 不是 太 喜欢 这个 地方 住 的 地方 吃饭 的 地方 都 是 各种 苍蝇 住 的 应该 是 当地 相当 不错 的 一个 酒店 了 仍然 各种 苍蝇	__label__2
很 典型 的 旅游景点 数不清 的 旅行社 去 哪个 地方 都 能 买 到 的 纪念品 油烟 特别 大 的 小吃 过度 修饰 的 仿古 建筑 永远 在 排队 的 公厕 说句实话 其实 去 上海 就行 啦 不用 去 南京 瞎折腾	__label__1
我 今天 早上 两个 大人 三个 小孩 全家 从美团 上 买 的 票 从 泰山 景区 入园 两个 大人 和 一个 大孩有 身份证 可以 入园 两个 小孩 没有 身份证 就 不 给 入园 了 两个 小孩 都 是 和 其中 一个 大人 身份证 购买 的 想 退票 大人 身份证 以 通过 没法 退票 找 客服 中心 说 一个 工作日 给 答复 景区 工作人员 可以 作证	__label__1
元人 感觉 就 像 坐 商场 升降 电梯 一样 大部分 时间 是 在 封闭 区域 内 看不到 风景 的 看到 风景 的 时间 也 很 短 一眨眼 功夫 就 到 了	__label__2
无趣 的 景点	__label__2
城市 内 公园 散散步 做做 晨练 好像 也 是 护城河 游览 的 中转站	__label__2
不 满意	__label__2
就 在 吴山 广场 西侧 感兴趣 的 可以 过去 看 一下	__label__2
夏天 去 是 最 漂亮 的 时候 但 降雨 比较 频繁 注意 防雨	__label__2
亲身经历 在 西樵山 北 门口 有 好多 摩托车 拉客 好 热情 千万 不要 理 他们 他们 会 说 上去 好远 带你去 坐 缆车 把 你 从 北门 带到 西门 这 还 不止 中途 还会 带你去 买香 好 贵 说 里面 没得 卖 其实 观音寺 里 有 卖 的 然后 再载 你 到 一个 叫 老庙 的 地方 拜 一个 所谓 的 观音像 和 财神 完 了 收 功德 钱 后来 才 知道 一切 只能 怪 人生地不熟 这些 人 竟然 拿 神明 来 骗人 太 无耻 太 缺德 诅咒 他们 不得好死 	__label__1
景区 内全 在 整修 路 也 乱七八糟 的 性价比 低 到极点 绕 一圈 就 出来 了 整修 期 怎么 可以 营业 卖票	__label__1
太坑 了 月亮 岛 基本 没有 东西 什么 什么 都 不好玩	__label__1
差 评说 好 的 猴子 都 没有 就养 了 几只 简直 是 花钱买 罪受	__label__1
整体 印象 真不知道 这里 是 怎么 评为 五星级 景区 的 沙滩 还 可以 但是 完全 无法 游泳 啊 防 鲨网 围起来 的 地方 最深 也 就 到 腰 没 围起来 的 地方 不让 下水 停满 了 大堆 摩托艇 降落伞 等 的 收费 项目 更衣 淋浴 的 地方 只有 冷水 且 无 提醒 门票 国庆节 大概 涨 了 近一半 总之 单次 的 价格 和 里面 的 服务 及 感受 相比 完全 没有 性价比 周边 周边 无论是 酒店 公寓 或者 饭店 都 是 乱糟糟 的 整体 感觉 就是 一个 大 农贸市场 的 感觉 住 了 一个 风帆 公寓 烂 到 让 人 无法 吐槽 的 水平 最后 应该 不会 去 第二次 了 顺便 感慨 下 优质 的 资源 能 这样 浪费 也 是 不 容易	__label__2
周边 的 黑 导游 太 多 一个 字 黑 两个 字 真 黑 愣 说 去 鸟语林 必须 游船 或 缆车 你 当 我 瞎 啊 缆车 要 游船 要 我 的 天 哪 昧心 出租车 给 我 介绍 了 一个 旅行团 上 了 黑车 使劲 宰 啊 我 不 就是 一个 外地人 吗 至于 吗 为了 孩子 能带 着 美好 游玩 老虎滩 哥们 我忍 了 你 说 分钟 一趟 的 游船 呢 我 需要 等 一个半 小时 没 办法 为了 赶时间 我 又 加 了 选择 快艇 我 的 天 那 说 必须 凑够 人 我 就是 贱 又 等 了 半小时 出去 之后 就是 外面 转 一小 圈 根本 不去 鸟语林 一路上 快艇 人员 还 推销 照相 我 是 来看 景 的 不是 来 听 你 磨叽 的 快艇 人员 还要 搞点 私活 一人收 五十 可以 再 多 转会 我要 吐 了 美丽 的 老虎滩 我 这 纯洁 的 心要 我 怎能不 爱 你 心 如 那 海洋 馆里 的 海豚 看着 一群 工作人员 在 表演	__label__1
國內 建築 尺度 都 不是 給人 走 的 都 是 給車 走 的 住 了 年 特別 討厭 這個 校區	__label__2
六横岛 的 海岛 世界 短板 依然 存在 没意思	__label__2
门票 一百 五 里面 小 景点 还要 另外 收费 纯属 坑人	__label__1
冬天 去 太冷 了 没 了解 到 什么 也 没 等到 讲解员	__label__2
公园 内 风景优美 秀丽 适合 散心 跑步	__label__2
一般般 没有 传说 中 的 那么 好看 不会 再 去	__label__2
吃饭 贵 门票 贵 索道 票贵 交通费 贵 求签 的 做 佛事 的 更 离谱 贵 路标 少得 可伶 却 处处 有 讨钱 的 一路上 都 有 迷路 的 人 问路	__label__2
非常 气愤 的 一次 体验	__label__1
性价比 很 低 游乐园 很	__label__2
有点 无聊 明天 到 东极岛	__label__2
最 简单 的 公园 吧 没什么 东西	__label__2
周末 人多到 要 疯 了 多 到 看 一眼 就 想 走 了	__label__1
十一 出游 很 开心 但 去 了 青山湖 后 整个 心情 是 拔凉拔 凉滴	__label__1
在 北方 遇到 冻雨 路面 结冰 各种 车祸 不得不 放弃 了 长白山 的 行程 没有 车 可以 徒步 没有 向导 可以 问路 没有 门票 可以 发挥 我 的 穷游 技能 _ | | 总之 最后 还是 成功 找到 了 魔界 可惜 的 是 时间 和 气温 都 不 适合 没有 雾气 更 没有 雾松天 不 给 力 即使 事在人为 也 只能 如此 了 吧	__label__2
门票 太贵 不 进去 这 难道 不是 拦路抢劫 吗	__label__1
纯粹 的 商业区 各类 吃货 、 购物 达人 的 聚居地	__label__2
只有 山 哪来 的 瀑布 伤心 开 了 单边 公里 不如 九寨 那个 沟沟 一点 都 不好玩 不 知道 怎么 那么 多 好评 你们 知道 景区 最 让 我亮 瞎眼 的 是 什么 吗 老板 来 一盘 盐 煎肉 你们 知道 吗 整来 一盘 全肥 标的 回锅肉 老板 硬 要说 他们 那盐 煎肉 就是 那种 在 来 个 鱼香肉丝 结果 你们 猜 怎么 的 来 了 一盘 肉丝 + 大葱 我勒个 去 这 分明 是 欺骗 我 是 好人 的 节奏 啊 总之 重庆 天生 三桥 乘兴而去 失望 而 归	__label__1
不好玩 收费 不合理 下次 不会 再 去 了	__label__2
吉林 江边 鸟类 聚居地 不看 鸟 的话 没什么 可看 的 不过 江水 没 污染 清澈 能 看到 石头 这点 不是 下游 的 哈市 能比 的 不过 哈市 江段 也 饱受 吉林 重工 污染 之害	__label__1
不 知道 该 说 什么 了	__label__1
非常 生气 的 旅游 体验 被 黑导 骗 了 打电话 投诉 对方 居然 不屑 地说 这么 明显 的 当 你 还 上 连 公共服务 都 是 这种 水平 我 只能 说 丽江 古城 一生 黑	__label__1
天气 不错 湖 景山 景 比较 一般	__label__2
这 文盲 还 真想 不 明白 高校 为啥 会 成为 景点	__label__2
骗子 就是 骗子 买 了 就 自己 消费 了 连 验证 不用 就是 骗子 还 不 退 说 的 如果 没用 核实 了 可以 退 就是 打 不 通电话 投诉 都 不 知道 找 谁 找 美团 协调 退 二百 剩下 的 留 着 买 敌敌畏 吧 不要 贪图 小便宜 不要 贪图 这种 小便宜 泰山 买票 很 方便 不要 在 相信 这个 谁家 钱 大风 刮来 的 出去玩 还 闹	__label__1
太 吓人 了	__label__1
排队 要 小时 辣鸡 辣鸡 辣鸡辣 鸡辣鸡	__label__1
客服 很 好 帮 我 催 了 订单 因为 本人 订单 比较 急 但是 我 去取 票 的 时候 因为 一个 同伴 身份证 没 找到 而 几张 票 都 正好 出 在 他 的 身份证 名下 开始 不 知道 打电话 问 客服 结果 他 语气 相当 不好 说 要 用 他 的 身份证 取 我 说 没带 他 明明 知道 身份证 号码 就 可以 取 却说 吓唬 我们 说 不关 他 的 事	__label__1
只是 一个 沙漠 版 的 儿童 游乐园 各种 收费 也 是 贵	__label__2
超级 不好 美团 买 了 张票 就 出 了 一张 在 山下 等 了 一个 小时 没有 出票 最后 还是 在 买票 才 上去	__label__1
这 景点 也 好意思 进 三山 和 黄山 齐名	__label__1
佛门 净地 已经 变成 佛门 领地 了 收 门票 没有 了 香火 还 算 一个 知名 皇家 寺院 吗	__label__2
烂透 了	__label__1
普陀山 元 门票 不 含 寺庙 的 门票 要 另 买 小票 船票 为 单趟 元 [ 生气 ] [ 生气 ] [ 生气 ] [ 害羞 ] [ 害羞 ] [ 害羞 ]	__label__1
说实话 我 每年 都 去过 很多 地方 滑雪 这 滑雪场 是 最贵 的 我 去过 滑雪场 中	__label__2
一般般 吧 主要 是 坑 游客 的 当地人 不太去	__label__2
呵呵 一人来 大兴安岭 看 观音 司机 是 真能 忽悠 啊 看 我们 外地人 人生地不熟 一脚 油门 就 把 我们 拉来 不 玩儿 也 得 玩儿 后来 的 同志 们 千万别 上当	__label__1
强卖 雨衣	__label__2
建议 春天 去 空气 好 还有 樱花 可赏	__label__1
湖本 以为 后会赏 欣悦 目但 略有 所 失望 随便 在 断桥 上照 了 几张 就 赶往 萧山 以 订好 的 酒店 住宿	__label__2
路过 的 一个 小镇 有 不错 的 火锅 比较 热闹 逛逛 还 行	__label__2
虽然 是 武汉 的 地标 但 的 票价 绝对 不 值得 一进 除了 后期 修建 的 黄鹤楼 四周 种 了 点 花花草草 也 不能 和 免费 开放 武大 和 东湖 比 性价比	__label__2
一家人 出来 玩	__label__2
八线 男演员 的 全国 暴走 计划 第站	__label__1
恶心 的 景点	__label__2
在 龙市 一个 闹市 里 孤独 的 一个 纪念碑 可能 因为 不 靠近 任何 景区 人 几乎 没有	__label__2
不要 你 给 我 太 多 不要 你 的 任何 承诺 也 不要 你 的 任何 责任 有时候 真的 很 喜欢 你 很 想 和 你 在 一起 有时候 又 真的 很累 很 想 放弃 你 偶尔 的 温柔 总让 我 觉得 如果 你 有 那么 一点点 喜欢 我 我 自己 却 放手 了 多 可惜 所以 就 为了 那些 不 知道 存在 不 存在 的 喜欢 我 等 了 你 好久好久 可是 后来 我 明白 我们	__label__2
不怎么样 一个 小 古镇 与 西塘 乌镇 无法比拟	__label__2
极差 景点	__label__1
文字 和 清明 上 河园 无关 铁塔 公园 继续 对 了 她 还给 安排 了 个 导游 心想 开封人 真不错 谁知 导游 给 带到 庙里 说 什么 龙脉 来 了 要 请 香 安排 几个 人 讲解 然后 带到 一个 大师 面前 让 花钱买 心安 最少 元 加元 请 完香后 导游 一句 话 今天 导游 结束 自由行动 靠 导游 就是 为了 骗 香火钱 的 完后 感觉 满满的 都 是 泪 啊	__label__1
景是 不错 就是 到 南天门 后 贼 坑 在 上面 吃 碗 拉面 贼 难吃 块钱 还 行 就是 在 上面 有点 冷 他们 还 限时 二三十 分钟 好气 估计 没 下次 了 下次 去 黄山 爬 去 吧	__label__1
不要 在 网上 订票	__label__1
差评 不要 买	__label__1
江南 三 大名 楼 我 没上去 只是 在 外面 看 了 看	__label__2
真心 没有 必要 去 全是 商业 仿古 建筑 还有 小偷	__label__2
今年 太 干旱 基本 没有 水	__label__2
对 道教 文化 完全 无感 满山 的 道观 一点儿 也 不 招人 喜欢 从 大门口 开始 从 大门 到 山 门口 要 电瓶车 费 进山 的 门票 也 不 便宜 进 了 山门 到 索道 口要 过湖 也 要 收费 索道 要 收费 要 排队 等到 下山 时 这些 费用 再 通通 收 一次 钱 也 太 好赚 了 风景 平平 无 奇 大约 是因为 地势 低洼 的 缘故 虽	__label__2
就是 为了 走 完全 程去 了 这个 地方 纯属 走 冤枉 了 没什么 必要 去	__label__2
当地人 真 不 咋 地 很 失望 不 厚道	__label__1
会 后悔	__label__1
干净 人 也 不算 很多 散步 不错 晚上 有 音乐 喷泉	__label__4
坑 啊 全都 是 坑 问 虾饺 多钱 一盒 说元 结果 结账 是 元老 难吃 了 一点 虾 都 没有 生煎包 没有 馅 都 是 皮 吃 一口 就 全 扔 了 白 瞎 这 条名 街 了	__label__1
浙江 建德 大慈岩 景区	__label__2
亮点 就是 不要 被 那些 所谓 的 导游 带 你 说 了 不用 导游 费在 那里 消费 吃饭 就 可以 带 之前 说 随意 消费 带 完 回去 马上 变脸 必须 点 那些 贵 的 离谱 的 菜 比如说 裸 斑鱼 吧 外边 说 多 块钱 一斤 的 在 那里 不要 就 不要 我们 走 那 找 最小 的 称 吧 秤 出来 块 这 是 吃 了 变 神仙 的 鱼 吗 第一	__label__1
山清水秀 风景优美 还有 许多 可以 烧烤 的 地方 赞	__label__2
一日游 团队 客人 已经 下 岛上 车 导游 把 客人 撵 下车 告诉 在 等 分钟 别的 团车 坏 了 让 我们 等 着 先 送 另 一个团 去 别的 景点 在 送 我们 回 三亚 事先 不 沟通 好 我们 可以 在 岛上 在 呆 一个点 现在 大家 在 马路边 上 坐等 知道 我们 散团 拿 他们 没 办法 再也 不用 这个 破 网站 订票 了 真 没 保证 啊 本来 玩 的 挺 好 一下子 印象 就 差 了	__label__1
进去 之后 只能 在 那个 荒芜 人烟 的 岛上 走 一圈 其他 别墅区 什么 的 都 不让 去 感觉 已经 很久没 人 打扫 路上 都 是 垃圾 重点 是 被 虫 咬 得 满脚 的 苞 惨不忍睹 居然 还 好意思 要 我 的 门票 应该 赔 我 精神损失费 一个多 礼拜 了 还 没 好 第一次 被 虫子 咬 到 的 去 医院	__label__1
我想 弱弱 的 问 一句 首都体育馆 算 景点 吗 平时 举办 各种 乱七八糟 展销会 有时候 租给 演出 团体 搞 商演 有时候 租给 单位 开 大会	__label__2
服务 差到 一个 极致 我 买 了 票 没有 使用 还 告诉 我 不能 退 稀烂 的 景区 坑人	__label__1
华 清宫 一个 根据 史籍 和 挖掘 遗址 硬造 的 一座 宫殿 是 以 卖 门票 为 目的 不是 以 保存 历史 为 目的 如果 可以 把 它 建成 骊山 国家级 森林公园 和 西安事变 博物馆 或许 更 合适 一些 现在 的 华 清宫 离 兵马俑 车程 分钟 依 骊山 脚下 而建 定义 为 唐皇 御用 温泉 浴池 群 各种 唐朝 历史 人物 都 在 此 被 洗过 温泉 皇上 、 妃子 、 臣工 、 杂役 各色 人物 皆 宽衣解带 留下 了 令人 遐想 的 种种 场景 捉 蒋亭 则 是 因 蒋介石 在 此 督战 时 被 杨张 软禁 但是 老蒋 是不是 可以 每天 也 泡 一泡 天然 温泉 呀 要是 可以 大总统 不 做 也罢 也许 就 能 多 活些 时日 呀 据说 华 清宫 的 夜间 水上 歌舞 表演 不错 但是 时间 不巧 没 看成 有 时间 的 就 去 看看 吧	__label__2
风景 很 好 可惜 没有 看到 夜晚 的 景色 值得 一游	__label__1
本人 通州 人 只 想 说 去 看看 可以 不要 抱太大 希望 公共交通 不 方便 都 是 开车 去 的 路边 停车难 停车场 远 玩 的 比 一般 公园 都 贵 里面 的 出租 自行车 也 贵	__label__2
被 忽悠 了	__label__1
想象 很 丰满 现实 很 骨感	__label__1
这个 世界遗产 国家级 景区 几乎 是 最令 我 失望 的 一个 了 而且 今天 还是 我 时隔 几年 后 的 第二次 参观 景区 公众 服务 太 差 旺季 旅游 的话 慎选 此地 参拜 大佛 全貌 前 需要 排队 时间 长 真的 很长 开始 排队 时 此时 早已 购买 过 门票 出门 即 作废 竟然 有 一条 告示 说 大概 需要 到 小时 建议 去 买 船票 在 景区 外江 上 看 大佛 欺骗 游客 嫌疑 太大 在 整个 排队 的 过程 中 没有 看到 任何 工作人员 参与 管理 秩序 全 凭 游客 自觉 然而 林子 大 了 什么 鸟 都 有 既然 选择 了 远 方便 只顾 风雨兼程 我 一点 也 没 开玩笑 因为 大佛 的 门票 价位 不低 暂 不 说 门票 捆绑 销售 的 崖墓 博物馆 和 乌 尤寺 了 而 旅游 人数 众多 景区 的 服务水平 如此 之低 实在 不 推荐 来 此地 旅游 如 确实 比较 钟意 此 景区 推荐 坐船 看 大佛 元人 比 徒步 便宜 元人 不 排队 又 能 更 直接 地 观看 大佛 或者 淡季 时来 礼佛 元人 不 说 无需 排队 可 更 轻松 地 更 虔诚地 拜 大佛 乐山 大佛 景区 管理处 做法 实在 有 辱 大佛 的 慈悲 更 无法 面对 海通 师傅 的 初衷 四川省 公共服务 如何 不敢 妄下 评论 但 就 景区 旅游 服务 来说 照 其他 一些 地区 相 比较 有待 提高 的 地方 太 多只 说 普通话 这 一项 太 不 符合 四川 诸多 世界遗产 以及 国家级 景区 的 身份 了 而 服务态度 等 其他 有待 大家 的 深刻 体会 有 机会 我们 一起 交流	__label__1
袁家界 和 杨家 界 印象 差不多 就是 看 地貌 没有 太 大 区别	__label__2
梦幻 家园 就 在 雪韵 大街 的 中段 单独 收取 门票 不 等 黑 呀 可以 砍价 或是 找住 在 民宿 的 老板 那里 买票 其实 就是 一个 巴掌 大 的 小院 如果 不是 专业 摄像 的 爱好者 或 个人 喜好 的话 大可不必 进去 自己 决定 吧	__label__2
真是 一个 坑	__label__1
很 荒凉 人少 人 都 在 城楼 那 了	__label__2
门票 里面 没什么 东西 放 的 都 是 一些 杂物 还有 生平 简介 路 就 一个 字形 太 不值 了	__label__1
不 咋 的	__label__2
比较 一般 的 景点 感觉 规划 的 有点 混乱	__label__2
温泉 感受	__label__1
好好 好好 来 了 加进来 怕 恩 木头	__label__2
还 不错 旅行 时间 如果 宽余 可以 转 一下	__label__2
在 网上 订票 想着 可以 直接 取票 不用 排队 了 哪 晓得 自助 取票机 都 是 坏 的 害得排 了 一 小时 坐 缆车 又 等 了 一个多 小时	__label__1
开发 的 像 商业街 祠堂 和 建筑 都 很 新 没什么 意思	__label__2
不 推荐 感觉 这里 出 了 甲午战争 纪念馆 意外 所谓 的 景点 都 是 挺 勉强 的 也 没有 特别 岛 挺 大 的 好像 一百多 还是 两百多 的 票价 一点 也 不值	__label__2
略 无聊 还花 好多钱 去 了 之后 决定 以后 旅游 再不去 寺庙	__label__2
个 小岛 连 成都 没 啥意思 看锁 、 看鱼 、 拍 婚纱 地 商业 气息 浓重	__label__2
下次 再也 不去 了 累死 人 啦	__label__1
我 悄悄的 告诉 你 其实 这个 塔 已经 是 新建 的 旧 的 早就 没有 了 你 还要 买票 进去 坐电梯 上去 看 吗	__label__2
一点 都 不好玩	__label__1
已经 没有 营业 了 每天 都 关门 推荐 大家 不要 去 不要 去	__label__1
不是 黄山 不好 首先 网络 自助 取票机 没 开要 人工 取票 其次 人工 取票 时候 有张 索道 取 不了 说 是 没有 看到 订单 无 语	__label__2
没 啥意思 比起 其他 的 博物馆 这里 阴森 多 了 人 也 很少	__label__2
街道 两旁 商业化 也 做 的 不好 纯粹 借路 去 卢沟桥 而已	__label__2
看到 那个 玉米面 馒头 一样 的 东西 我 突然 想 笑 我 只 想 说 有些 东西 毁掉 了 就是 毁掉 了 怎么 重建 都 建 不 起来 的	__label__1
国庆 没 地方 去 同学 说 要 不 附件 走走 选来 选去 就 选 了 衡山 然而 十分 失望 山 底下 排 了 三个 小时 的 队 买票 上山 一路 了 除了 爬山 走 石阶 基本 不能 算 风景 了	__label__1
大理 崇圣 三塔	__label__2
大爷 大妈 的 广场 舞 真是 绝 了 居然 还 能 为了 抢 地方 打 起来	__label__2
年 月 由 王佐 负责 在 上 井 办起 了 第一所 红军 造币厂 造出 了 仿 墨西哥 版式 的 红军 工字 银元 这是 井冈山 革命 根据地 内 也 是 中国 红色政权 的 第一批 金属货币 为 粉碎 国民党 军队 的 经济封锁 发挥 了 重要 作用	__label__2
只能 说乱 人太多 管理 几乎 没有 交通 也 不是 很 方便	__label__2
建议 来 青海湖 就 不要 去 什么 景区 了	__label__1
没什么 好看 的 里面 爬山 累 到处 都 要 收费 东西 贵得 厉害 哎 完全 是 变向 的 为 水利工程 捐钱	__label__1
nan	__label__5
楠溪江 最差 的 景点	__label__2
很 普通 的 夜景 江景 咯 这 名字 我 也 是 刚 知道	__label__2
这个 明明 叫 圜丘 当然 现在 的 回音壁 也 不 值得 去 了	__label__2
就是 一些 卖东西 的 地方 性质 等于 重庆 磁器 口 但是 感觉 人 不是 特别 多	__label__2
坑爹 好 么 我 从 武汉 一路 驱车 玩来 期待 的 心情 大家 能 懂 么 我 把 这里 当 终点 其他 景点 都 是 顺路 一看 结果 结果 景区 维修 不能 进日 了 狗 了 是不是 任何 地方 都 没有 通知 任何 被 坑 的 小 车队 陆陆续续 的 往 景点 开 分钟 后 就 开 出来 我 不 愿意 走回头路 我 想 我 是 不会 再来 了	__label__1
人多车 多	__label__2
整体 感觉 非常 不好 没有 直达 公交 没有 地铁 接驳 车 景点 之间 也 没有 接驳 车 还好 可以 打 私家车 来往 各 景点 价格 都 挺 公道 的 个人 觉得 只 参观 定陵 和 神道 就 可以 了 昭陵 真心 不 建议 去 浪费时间 建筑 旧旧 的 好多 垃圾 又 小 没 看头 很 浪费时间 的 一天	__label__1
烂 真的 很烂	__label__1
上 索道 票 不能 在 下 索道 站 补 差价 两个 索道 又 隔 很 远 退票 不 方便	__label__1
失望 还 什么 天池 就 一个 小井 就 冠名 天池 我 觉得 名不符实	__label__2
不是 很 推荐 进去 感觉 外面 看看 就 好 了	__label__1
景色 很 美 只是 下 大雨 了 早早 就 出来 了 好多 都 没 看 上 人太多 排队 排 好久 地震 前一天 去 的 看 了 个 绝版  门票 有点 贵 啊 里面 也 没有 什么 设施 就 大自然 馈赠 人类 的 美景 还收 这么 贵 的 门票 里面 的 饭 也 超 难吃 建议 去 自己 带	__label__2
人造 景点 非常 的 不 推荐 去 实在 是 太假 了	__label__2
这种 景点 还 收费 你 穷 疯 了 是 吗	__label__1
就是 个 家里 的 菜园 没什么 看 的 过来 的 人 估计 是 缅怀 鲁迅 先生 吧	__label__2
上当 了	__label__1
千万 不要 买 就是 浪费 钱 声音 很小 也 很少 很少 有 介绍 有 也 听不见	__label__1
排队 好不容易 排到 了 没 办法 手机 支付	__label__1
游 西湖 的 时候 听 船夫 说 雷峰塔 早已 不是 当年 的 模样 不 建议 去	__label__2
没什么 特色 节假日 人多 挤 着 进去 挤 着 出来	__label__2
就 像 每 一个 小城镇 到 大都会 的 样子 上海 的 东方明珠 成 了 外地人 的 聚集地 观光 电梯 太空舱 其实 在 远处 眺望 下 就 好 了 属于 那种 不去 的话 后悔 去 了 后 此生 不会 再 去 第二次 的 景点	__label__2
没有 以前 感觉 好 了	__label__2
还 行	__label__2
烂死 了	__label__1
真 心想 不 明白 为什么 这 是 个 五星 景点 景色 一般般 收费 还贵 路线 规划 和 路标 不 清晰 搞 得 游人 一头雾水 首先 可能 是 船 比较 大 所以 船次 较 少 错过 一班 要 等 半小时 真的 是 很 浪费时间 船期 也 没有 标明 没 人 知道 什么 时候 来船 如果 有 船期 大家 还 可以 根据 时间 来 规划 每个 点玩 的 时间 第二 路标 指示 不 明确 第二个 景点 巴王 寨 下船 的 时候 可以 选择 坐 扶梯 也 可以 步行 问题 是 路牌 全部 指向 扶梯 一边 然而 步行 是 反 方向 的 走 了 不少 冤枉路 而且 下船 之后 是 往回 走 的 就是说 巴王 寨 在 第一个 下船 点 ( 第一个 景点 ) 与 第二个 下船 点 之间 从 第一个 景点 走 去 巴王 寨 顺路 但是 从 第一个 景点 坐船去 第二个 景点 ( 巴王 寨 ) 还 得 往回 走 分钟 游玩 后 原路 返回 第三 作为 一个 五星级 景点 游船 上 的 音频 介绍 非常少 起码 说 清楚 游览 路线 吧 介绍 多点 历史 文化 不要 只 懂 通知 下船 时 小心 此外 还 需要 注意 不是 每个 码头 都 是 可以 坐船 的 里面 还 混杂着 两坝 一峡 的 游船 所以 要 看清楚 是 景区 游船 还是 联合 游览 的 船 总之 不 推荐 有钱 没 地方 花 的 可以 去	__label__2
觉得 票价 和 演出 内容 相比 略贵 了	__label__2
嗯 著名 的 基佬 圣地 走 在 附近 记得 夹紧 屁股	__label__2
不 值得 去 不 值得 去 不 值得 去	__label__1
糟糕 的 体验	__label__1
实在 是 太 商业化 了 一点 都 不 推荐	__label__2
呵呵 这种 地方 还是 表去 了 阴气 太重	__label__1
难道 是 说 我 去 的 不是 地方 吗 我 导航 过去 的 到 地方 了 告诉 我 就 一个 渔阳 滑雪场 和 一个 高尔夫球场 如果 青龙山 指 的 是 高尔夫球场 上面 那 是 说 还 得 先 半个 会员 吗 到底 是 这里 评论 的 都 是 土豪 还是 说 导航 坑 我	__label__1
比较 失望 地方 不 大 大部分 都 是 现代 建 的 不好玩	__label__1
差劲 景区 特别 小半 小时 走 完 到处 是 收费 湖边 全 被 人工 设施 占据 连 照相 的 地方 都 没有 油菜花 海叶 也 全 没有 只有 荒地 油菜花 景区 外 却 一片 一片 的 破坏 美丽 亵渎 大美 这样 的 骗子 景区 不 值得 去 应当 拆除 回复 自然 的 美丽 上当 去 一次 上当 一次	__label__1
我 就 想 知道 是 哪个 人 改版 的 打卡 真 每天 抽奖 也 都 是 一个 蜂蜜 是不是 傻	__label__1
自驾游 雪乡 之 旅 — 真实 感受 哈尔滨市 到雪乡 大概 有 小 四百公里 第一天 中午 从 市里 出发 到雪乡 脚下 的 一个 小 旅馆 住 下 旅馆 叫 福临 聚 炕间 两人 携程 应该 不到 后来 看 了 一下 点 了 三个 菜 菜单 上面 写 了 菜价 过节 有 微调 其实 是 调 了 一半 可能 是 吃 不惯 东北菜 吧 四个 菜 都 没动 实在 很 难吃 回 房间 吃 的 泡面 、 萝卜 白菜汤 是 萝卜丝 和 牛肉 丝 煮 的 煮 出来 是 黑色 的 牛肉 应该 是 放 了 很 久 或者 上 一顿 吃 了 的 有 炒 过 的 痕迹 再说 说 鱼香肉丝 炒 出来 一个 难闻 的 味道 颜色 什么 都 没有 根本 没法 吃 还有 一个 煎蛋 没有 味道 、 一共 花 了 多 、 第二天 早早 就 上 了 雪乡 里面 不让 车开进 去 停 在 景区 门口 门票 之后 坐车到 雪乡 里面 雪景 是 很 美 一般 地方 看不见 随后 找住 的 地方 在 一个 叫映 雪阁 的 地方 住 下 了 一个 标间 讲 了 讲价 老板 看 马上 能住 就 给 了 一般 那里 的 住宿 往 上 而且 他们 会先 让 住 炕间 因为 这样 的 房间 他们 不好 卖 那里 的 饭菜 大概 是 土豆丝 花生米 林蛙 多一份 带肉 的 就 可想而知 了 而且 饭菜 真心 吃 不 下去 我 从 到 雪乡 脚下 到 走 的 时候 一直 去 外面 点餐 都 吃 不 下去 都 是 回去 吃 的 泡面 梦幻 家园 + 二人转 的 票 是 在 携程 上 买 的 两张 套票 不到 五百 很 实惠 倒 是 取票 的 过程 很 繁琐 打 了 很 多次 电话 在 到 取票 人 手里 拿 了 两次 分开 取 的 二人转 的 票 拿 的 是 晚上 十点 的 再说 说 二人转 根本 没什么 可看 的 不 搞笑 说词 也 是 在 网上 经常 的 用语 我们 进去 之后 已经 没有 位置 在 第一排 买 了 一个 座位 临近 舞台 两边 的 位置 都 要 出钱 才能 做 块钱 一盘 花生 瓜子 两 啤酒 小 橙汁 瓶雪乡 大街 什么 都 没有 卖 的 你们 不要 以为 和 一般 小吃街 一样 街上 全是 卖 冻梨冻 柿子 羊肉串 据 当地人 说 也 不是 什么 好肉 其他 什么 都 没有 卖 的 了 所以 期望值 不要 太高 第二天 准备 走 遇到 头 天下 过雨 封路 三条 道 都 不让 走 早上 在 映雪阁 吃 的 早点 一位 后来 才 看见 吧台 写 的 入住 免 早餐 结果 老板娘 在 我们 不知情 的 情况 下收 了 我们 我们 两个 人 吃完饭 老公 去 拿 了 听 王老吉 老板 要 了 元 八点 左右 就 退房 了 退房 的 时候 床单 上 有 两块 污渍 是 晚上 喝啤酒 的 时候 洒 在 上面 的 老板 又 要 了 后来 想着 去 看看 什么 时候 能 走 刚 走 出去 就 说 不让 走 连雪乡 都 出不去 没 办法 又 回到 映雪阁 告诉 老板 再 让 我们 呆 一会儿 反正 房间 也 没 收拾 要 不 就 在 开 一间 房钱 照样 给 开道 了 就 走 老板 就 说 那个 房间 都 订 出去 了 现在 没有 房间 了 要 的话 还有 四个 人 的 抗间 一分 不少 坐地 起价 后来 听 别的 导游 说雪乡 不来 终身 遗憾 来 了 遗憾终身	__label__1
门票 很 贵 东西 都 在 修 不值	__label__1
敖 东城 已 消失 希望 百度 旅游 把 这个 景点 删除 不要 在 误导 旅客	__label__1
明清 建筑 纪念 儒家 大师 孔夫子 的 地方 可以 看看	__label__1
不怎么样 不能 拍照 排队 时间 长人 也 丑 不 知道 有 啥 好看 的	__label__1
和 所有 的 古镇 都 差不多 一个 特色 只有 村口 的 那个 湖 看上去 舒服 一点 这 也 是因为 那个 啥 电影 在 这 拍 才 出 的 名 这种 环境 得 寂静 时 才能 体现 那种 韵味 现在 人太多 了	__label__1
江南 第一家	__label__2
本来 对 这个 景点 是 有 期望 的 八月 算是 最好 的 季节 了 结果 并 不好 如果 你 能 在 这个 景点 坚持 三 小时 那么 差不多 有 一 小时 在 外面 排队 买票 排队 进场 那么 贵 的 门票 进去 以后 什么 都 没有 小 火车 还要 排队 单独 买票 一 小时 发 一班 加上 你 排队 的 时间 额 除非 刚刚 好 否则 傻缺 才 会 坐 电瓶车 也 要 单独 排队 买票 然后 排队 坐 也 不是 个 把 小时 能 搞的定 的 好 吧 咱 农村 人 不怕累 走路 吧 里面 盐湖 里 也 不白 到处 有 黑黢黢 的 不过 需要 提醒 要 去 的 一定 要涂 防晒霜 包括 脚	__label__2
来 这 就是 消费 山上 风景 不错 但 工作人员 态度 不好 太 差劲 了	__label__2
我 想 去 桂林 玩 可是	__label__2
单位 组织 去 的	__label__1
去 完 第一 感觉 人多 第二 感觉 是 时候 回家 了 景点 跟 价格 匹配 不上 不 推荐 去	__label__1
烂透 了 护国寺 小吃 不要 太 难吃 建议 想 吃 北京小吃 的 来 牛街 试试	__label__2
有点 坑爹 门票 然后 里面 什么 都 没有 刚 进门 让 做 车元 每次 然后 就 分钟 [ 无奈 ] 还有 就是 自助餐 什么 都 是 骗人 的 不过 青海湖 风景 还是 不错 的 可以 坐坐 冲锋 艇 或者 游轮 [ 酷 ]	__label__2
凑活 吧	__label__2
就是 仿建 的 隋唐 风格 适合 拍照 但 门票 觉得 有点儿 贵	__label__2
坑 外地人 的 买 个 小 煎饼 十块 换成 果子 加 五块 饭 也 是 很 难吃 咸 的 要命	__label__2
白 瞎 浪费时间 里面 坑人 坑 旅游 的 人	__label__1
一代 名妓 苏小小 到 此 就 不难 想起 李贺 的 题 苏小小 墓 感叹 红颜 命薄 啊	__label__2
贵 真心 贵 下午 点前 就 没 了 索道 我们 走 下山 都 晚上 点 了 还 算 天气 不错	__label__1
真 不好玩	__label__1
出票 迅速	__label__2
实在 是 不 值得 一去 都 是 年代 以后 重新 修 的 武汉 灰 很大 别来 黄鹤楼 也 不 好看	__label__2
山海关 名气 挺大 的 但 真正 到 了 之后 就 能 感觉 到 那种 现实 和 记忆 中 的 落差 不好 不 值得 去	__label__2
很差 的 一次 体验	__label__2
携程 一家 极 不靠 谱 的 公司 管理混乱 误导 客户	__label__1
服务 太 差	__label__1
比 想象 中要 更加 不错 的 地方	__label__2
防坑 景点 门票 贵 性价比 不高 还 不如 在 藏民 的 地盘 上 一辆车 花 块钱 进去 玩	__label__1
杭州 湘湖 旅游 度假区 是 新 开发 的 一个 人工湖 景区 他 本身 就是 仿 西湖 制造 的 当然 这里 没有 西湖 那么 人多 不会 有 什么 高峰 人流 所以 喜欢 安静 游湖 的 朋友 还是 可以 来 这里 玩 的 这里 有 西湖 拥有 的 很多 相似 景点 而且 面积 也 不小 不过 唯一 一点 就是 这里 很多 都 是 人工 后期 做成 的 没有 西湖	__label__2
夏天 最好 不要 来 一线天 内 味道 很大 又 骚 又 臭 排队 进去 后 无法 退出 感受 很差	__label__2
杭州 必去 的 景点 不用 买票 但是 说 实在 的 确实 没 啥 很 一般 去过 的 人 基本 都 后悔	__label__2
本来 想 为 自己 以后 的 宝宝 去 探 探路 的 结果 在 里面 走 了 一个 小时 就 出来 了 设备 太 陈旧 都 是 教科书 式 讲解 总结 一点 : 去 了 一次 不想 去 第二次	__label__1
我 准备 去 明天 的 火车 到底 开通 没 如果 没有 只能 去 玻璃 栈道 了 失望	__label__1
管理 太 差 承载 不了 那么 大 的 旅客量 就 少 接待 嘛 进山 的 时候 质量 把 我们 放在 树正海 还 可以 理解 下山 的 时候 先是 把 我们 放在 两沟 交汇处 然后 排 很长 的 队 上车 这 也 还 稍微 能 理解 嘛 最 可恶 的 是从 两沟 交汇处 上车 后 到 树 正海 又 把 我们 放下 了 大家 下山 的 时候 都 累死 了 就 想 下山 了	__label__1
一般 一般般 一般般 一般般 没有 什么 特色 推销 拍照 不 提供 发票 总之 景点 没 啥 特色	__label__2
充分利用 原址 修建 的 噱头 尽 骗人 之能事 元 的 价格 和 北京 的 圆明园遗址公园 相比 简直 是 差 几个 世纪 仿古 建筑 却 又 没有 实质 的 内容 算 一个 大众化 的 公园 还 勉强 政府 这样 赚钱 是 心 黑 么 大家 去 评判 吧	__label__1
此次 旅行 真的 特别 不 开心 早晨 点 就要 去 集合 坐 大巴 这到 没什么 重点 是 跟 团到 了 那 之后 点多 才能 进岛 再说 一说 坑人 的 海洋 文化馆 还 宣传 是 亚洲 最大 的 真的 特 没意思 而且 各种 收费 游个 泳存 东西 元 一个 箱子 一次性 的 哈 就是 只能 用 一次 如果 打开 了 就要 再 付钱 游 完泳 之后 冲个 淡水 元 大人 小孩 一个 价位 里面 吃 的 也 特别 贵 建议 自己 带点 水 和 吃 的 一个 鸡 蛋炒饭 就 而且 去 山顶 的 电瓶车 元 一人 不 坐车 就 不能 上山 导游 说 的 也 不 知道 为什么 山上 好多 景点 也 不能 看 都 给 封上 了	__label__1
不 喜欢 太坑 钱 了 去 一家 农家乐 吃饭 只点 了 四道 菜 却 要 两百多 块 少林寺 变成 了 一个 只要 钱 和 名利 的 地方 真是 难 为了 那些 来 这里 修行 的 小 和尚	__label__1
能 在 百度 旅游 看到 到 家乡 的 这个 景点 也 很 惊喜 在 此作 下 宣传 一个 有点 历史 的 小 寺庙 人气 还 比较 旺 可以 直接 开车 上去 但 我们 一般 喜欢 走路 去 边 看 风景 还 锻炼 哈哈	__label__2
小时候 去过 很 不错 还有 鳄鱼 呢	__label__1
秋天 观 枫叶 绝佳 景点 票价 还 不贵	__label__1
这里 的 餐厅 对外开放 也 有 各个 国家 的 餐厅 实惠	__label__2
我 去过 环境 不错 当时 票价 是 现在 听说 休 的 更好 了	__label__1
还好 吧 没什么 好玩 的	__label__2
红叶 、 行宫 、 别墅 位于 西山 每日 领 来 送往 国内外 游客 不过 中午 就 能 下山 的 绝对 是 老 北京	__label__2
不想 再 去 第二次	__label__1
太 不好 了 、 这个 地方 竟然 也 算 景点	__label__2
感觉 就是 一个 公园 并 没有 什么 意思 如果 有 唱 小曲 的 表演 可能 还 更 吸引 人 一些 门票 实在 是 有些 贵 了	__label__2
没什么 风景 看花了 元 门票 看潮 真心 觉得 太 不值 这个 点 不 好看 建议 去 大 缺口 或 老盐 仓	__label__1
开春 了 合计 带 孩子 去 踏青 结果 去 了 好 后悔 除了 人 啥 也 没有 千万别 去	__label__1
趁着 这个 地方 给 蚂蜂 窝 提个 建议 点评 需要 设置 负值 东单 公园 是 亚洲 最大 的 断臂 游戏 地 儿童 、 青少年 、 老娘们儿 、 老爷们儿 都 不要 去 啊	__label__1
鲁迅 先生 还好 吧 不是 特别 欣赏 的 文人	__label__2
停车场 收费 了 没有 发票 我 说 工作人员 怎么 不 给 发票 他 说 没有 等 我 回去 开车 的 时候 却 有 一群 不讲理 的 保安 要 我 重新 给 停车费 感觉 被 坑 了	__label__1
岳麓书院 真的 一般 是 一个 看 情怀 的 地方	__label__2
真心 不 值得 去 大多 是 小孩子 喜欢 的 玩乐 就是 玩 沙子	__label__1
这个 岛 就 更 无聊 了 就 一个 什么 海瑞 祠	__label__2
不 建议 去 西湖 玩去 西溪 吧	__label__1
第一次 的 时候 对 北京西站 印象 不错 可 现在 觉得 十分 不合理 取票 乘车 都 很 麻烦 诶	__label__2
丽江 的 人 一年 比 一年 多水 一年 比 一年 浅 还是 最 怀念 第一年 去 的 时候 纳西 古乐 值得 一赏 听 起来 和 哀乐 日本 国歌 类似 但 其实 是 当时 的 宫廷 雅乐 调式 美	__label__5
人太多 排队 等候 时间 太 长 旅游 的 时间 很 宝贵 可 别 耽误 在 排队 上 如果 不是 有 什么 特殊 意义 建议 别去了 旁边 还有 更 高 的 楼 可以 看景	__label__2
地方 很 破旧 没什么 可以 拿 出来 夸耀 的 只能 说 是 作为 一个 路过 而已	__label__1
还行 吧 就是 去 的 时候 有点 热 不是 很 热 所以 我 并 没有 爬 就 看 了 看	__label__2
路边 乱 指挥 的 不要 理 他们 我们 已经 亲身经历 了 骗子 这边 好像 是 山寨 版本 的 兵马俑 门票 是 元 真正 的 是 兵马俑 门票 是 元 最后 一张 图是 真正 的 兵马俑 门口	__label__1
當天 我 是 先去 兵馬俑 再 去 這裡 的 我 去 的 時候 雨天 那裡 就 像 外國 的 葡萄 園一樣	__label__2
年 来 的 时候 导游 专门 领 我们 去 看 那口井 那时 觉得 那里 的 小吃 都 不错 年 后 再 来 感觉 太 一般 了 看到 一串串 的 蝎子 想 拍下来 还 被 喝止 至于 吗	__label__1
过度 开发	__label__2
个人 觉得 比较 一般 我 是 去 八达岭长城 顺便去 的	__label__2
虽然 去过 了 到 现在 我 也 不 知道 它 是 干什么 的 不 推荐 去 游玩	__label__2
味道 太 差	__label__1
去 到 的 时候 已经 关门 了 透过 门缝 看 去 建筑 还是 很 有 气魄 很 有 特色 的	__label__3
就是 一个 普通 的 寺庙 但是 卖出 了 故宫 的 价格 还 不止	__label__2
本来 很 期待 的 去 的 时候 雾 很大 排队 很 长时间 就 那么 几步 一点儿 也 不 刺激	__label__2
听说 景区 是 承包 给 村民 的 代表 大自然 来 给 个 差评 风景 本身 是 好 的 景区 管理 不忍 直视 签名 三分之一 的 路 滑轨 的 水泥 桩 就 插 在 溪水 里面 休息 的 亭子 里面 没有 垃圾桶 满地 垃圾 没 人 清理 最大 的 瀑布 被 用 一个 巨丑 的 桥 拦住 要 交钱 才能 上去 山上 到处 都 是 垃圾 别跟我 说 是 游人 素质 差 油漆 桶 和 建筑 垃圾 都 堆 在 那里 写个 保护环境 的 标语 你们 他妈 是 在 逗本宫 吗	__label__1
也许 是 时间 不 对 现在 去 看 沙雕 真的 是 各种 郁闷 沙雕 各种 破损 而且 非常 单一 没什么 好看 的 都 收 了 门票 也 不 好好 维护 我 也 是 醉 了 让 我们 进去 看 什么 ? 就 大海 吗 ? 和 旁边 不 收钱 的 海滩 比 起来 没 差别 我 和 我家 先生 进去 逛 了 半小时 不到 就 出来 了 门票 一人元 真的 是 心痛 后来 在 隔壁 找 一家 饭店 吃饭 老板 告诉 我们 下午 点后 进去 是 不收 门票 的 我 去 这 下 好 了 肉 也 跟着 痛 了 不过 就算 不 收 门票 我 也 不觉 的 有 什么 好 逛 的 如果 你 一定 要 去 我 也 不 拦 着 去 体验 一下 心痛 的 感觉 吧 或者 建议 点后 进去 免票 晃 半小时 出来 天 还 没 黑	__label__2
近距离 看 这个 塔 还是 斑斑驳驳 的 年久失修 啊	__label__1
景 很 美 但是 携程 服务 太差 一 开始 取 不了 票 然后 双方 互相 推 责任 在 景区 等 了 近 一个 小时 才 进去	__label__2
老街区 小店 卖 淘宝 同款 的 手工艺品 逛逛 看看 本地 特色 就行了	__label__2
景区 管理混乱 就是 一个 围湖 的 公园 不 值得 前往	__label__1
完全 就是 一个 钢筋水泥 的 人造 商业 市场 如果 你 不想 在 同质化 的 商业街 浪费时间 劝 你 别去了	__label__2
建议 别去 没 啥意思 还 被 坑 了 一把 去 了 个华楼 区妈 的 智障 本来 来 青岛 挺 开心 的 被 崂山 人 失望 了	__label__1
订票 总数 张 计划 去 黄山 风景区 票共定 张票 三张 学生票 与 三张 成人 票因 计划 有变 仅取 了 张 成人 票 当天 早上 点 就 申请 了 另外 四张 票 的 退款 打 客服 电话 无数 一直 没人接 听 今天 时间 就 过期 了 那 我 没有 退 的 钱 怎么办 你们 的 服务 让 人 堪忧 都 是 一百多 的 票 让 普通 消	__label__1
一般 很 无聊 的 过去 也 就 看看 妹子 人挤 人 还要 如果 你 比较 矮 的话 建议 你 坐船	__label__2
垃圾 太 多 骗子 太 多 整体 感觉 泰安 人民 不 和谐 不想 再 去 了 如果 能 给 负星 那 就是 负 五颗星	__label__1
超级 坑 的 一个 地方 建议 出行 的 小伙伴 改 去 别的 更 好玩 的 地方 什么 唐人 文化园 那些 比 青秀山 好玩 多 了	__label__1
广场 没 啥 特色 车 特别 多 不过 可以 去 旁边 的 南湖公园	__label__2
景区 在 环湖公路 国道 边 黑马河 镇前 门票 淡季 元人 旺季 元人 主要 是 乘船 到 鸟岛 外 和 基地 游 下 青海湖 没 啥 好玩 到 附近 湖边 牧民 开辟 的 湖边 景点 可以 亲近 青海湖	__label__2
商户 存在 嫌疑 盗取 个人 财物 将 投诉	__label__1
就是 一个 少有 特色 的 公园 而已 没 啥意思	__label__2
贵 没 多少 意思 能 逛 一下 但是 不值 不 知道 是 怎么 评上 的 门票 什么 都 不 包含 节目 也 就 人 跳舞 水果 品尝 元 一盘 另外 付费 的 在 外面 可以 买 几斤 了	__label__2
破 城楼 一座 门票 元 以前 现在 降级 到 连 都 不如 就是 天下第一关 几个 字烂	__label__1
不是 很 满意	__label__2
网上 定 门票 套餐 坑爹 啊 不能 用 还 不 给 退款 订票 可 一定 咨询 清楚 再 定	__label__1
票价 贵 性价比 极低 不会 再 去 也 不会 推荐 别人 去 ( ^ _ ^ )	__label__2
除了 爬 台阶 还是 爬 台阶 单调 死 了 山路 太远 也 没有 个 指示 你 距离 南天门 中 天门 还有 多少 路	__label__2
因为 在 南京 所以 出名 了 和 其他 地方 的 夫子庙 差不多	__label__2
人太多 项目 少	__label__2
相比 起水涛 沟 这个 景点 显得 没有 什么 价值 全程 也 没有 什么 特别 重要 的 景点 单程 路 还 得 原路 返回 不 建议 走	__label__2
昨天上午 去 南京 中山陵 从 上午 十点 左右 一路 几个 景点 下来 到 下午 三点 多 兴致勃勃 意尤 未尽 历史 祖国 秋景 山河 但 还是 遗憾 离开 中山陵 景区 停车场 是 按 小时 收费 进场 没 提示 自动 上杆 出来 一问 元元 一 小时 一叠 小 发票 若大 的 景区 一天 也 一 玩 不 下来 明显 是 按时 收钱 弄钱 那有 ＂ 民生 ＂ 两字 自驾游 几年 停车 景点 无数 头次 遇到	__label__1
没意思 处处 坑 门票 管理混乱	__label__1
没有 想象 中 的 好 商业 气息 太 浓	__label__2
差差 差	__label__1
非常 一般 待 开发 的 古镇	__label__2
兵马俑 的 捆绑 景点 说 是 先 看 始皇 再 看兵 其实 秦始皇陵 并未 开发 去 了 只能 听 导游 指着 地下 介绍 脚底 下 就是 皇陵 的 中心 位置	__label__2
第二次 来 西湖 给 我 的 感觉 还是 一如既往 的 乱 差 这次 带 家人 自驾游 过来 遇到 交通管制 先是 单双 号 限行 然后 西湖 很多 路段 单行道 导致 明明 快到 酒店 只能 原地 绕 一圈 车 多人多 又 遇到 交通拥堵 好不容易 到 了 酒店 附近 找 不到 地方 问 了 周边 几家 饭店 店面 的 人 都 说 不 知道 各个 板 着	__label__1
不 满意 旅游	__label__1
盛名之下 其实难副	__label__2
很小 很 无聊 建议 大家 千万别 去         	__label__2
说实话 挺 没劲 的 不过 基本上 每个 旅游 城市 都 会 有 这么 一条街 吧 吸引 游客 嘛	__label__2
大家 不 觉得 这 是 个 山寨 吗 假如 没有 玻利维亚 有人 会 炒作 这里	__label__2
虽然 不 推荐 但是 作为 东南 湖区 的 行程 之一 不得不 来 天池 真的 很坑 不能 忍	__label__2
很烂 的 景点 块 都 不值 之前 打 了 很多 字 不让 我发	__label__1
箭 扣 长城 的 隔壁 没有 对比 就 没有 伤害	__label__2
高兴 而 去 惊魂 而 回	__label__2
景区 厕所 太少 了 而且 学生票 不能 通过 网上 购买 验证 的 时候 也 不 通过 去 景区 换票 排 那么 长 的 队 最后 才 说 直接 刷 身份证 就 能 进 各项 设施 设置 都 不够 完善 完全 配不上 这个 景区 的 知名度	__label__1
门票 贵可 看 的 东西 少 都 是 新建 的 还是 不要 去 了 建议 去 老龙头 比较 好	__label__2
风景 是 好 的 配套 服务 极差 几万人 只有 一个 检票口 都 挤 在 那里 如果 下雨 呢	__label__1
真的 我 从来不 喜欢 差评 的 但是 这次 我要 给 美团 的 的 后台 一个 大大的 差评 这 张票 从 月 开始 申请 退款 先是 说 号 上班 后 号 再 让 等 天号 等 平台 上 退款 日期 号 号 到期 后 不仅 不 给 退款 还 直接 发短信 告知 我 已 使用 了 打电话 说 系统 出 问题 了 还 让 我 等 你 只要 打电话 就是 耐	__label__1
就是 个 坑 网上 看 介绍 说 有 多 壮观 去 到 大失所望 如图所示 一个 搭建 起来 的 外墙 里面 围着 一滩 比 路边 水塘 还要 浅 的 水 还是 闭门谢客 的 啥 都 没有	__label__1
很 一般 的 景点 最大 的 感觉 就是 大 为什么 大 因为 之前 住 了 一个 村自 的 人 也 正是 因为 住 了 人才 能 在 十年浩劫 中 保存 下来 但是 还是 有受 影响 作为 难得 真品 的 牌匾 居然 是从 人家 猪圈 里 找 回来 的 国家 的 不幸 啊 印象 最深 的 就是 那 盏灯 但 却是 一个 赝品 塑料 做 的	__label__2
长春 解放 纪念碑 是 长春 抗战 胜利 的 标志	__label__2
没有 什么 好 演出 了 味道 较 老	__label__2
这 都 能算 旅游景点 吗 如果 算 的话 那 真是 给 嘉兴 旅游局 打脸 啊	__label__2
动物 种类 也 不是 很多 嘛 小孩 去 的 不少 大人 嘛 可 去 可不 去 吧	__label__2
很 一般 建议 别去	__label__2
七月份 去 长白山 应该 穿 什么 呢	__label__2
按照 蚂蜂 窝里 的 交通 指示 到 的 大峡谷 和 图片 里 的 完全 是 两码事 两个 地方 也 相隔 十万八千里 本来 是 冲着 红色 的 岩石 峡谷 去 的 结果 到 地方 一看 入眼 的 却是 森里 草场 湖泊 真的 是 懵 逼 了 简要 说 说 我 的 经历 : 在 黄河路 和田 街 的 市郊 客源 站 买 到 板房沟 的 车票 车站里 设有 一个 景区 售票点 在 那 买 大峡谷 门票 一张 可 省去 到 终点 后 折返 几百米 到 景区 售票点 的 麻烦 景区 区间车 一个 人 但是 只能 走 公里 的 一段路 山上 比较 险峻 的 位置 区间车 是 不到 的 想要 绕园 一周 下 区间车 之后 自己 还要 走 很 远 至少 有 公里 的 样子 可以 在 终点 附近 拼个 私家车 也 是 块钱 一个 人 可以 带 你 在 里面 跑 一圈 想 拍照 的 地方 可以 随时 停车 可以 出来 的 时候 再 给钱 天山 附近 的 景观 大致相同 而且 此处 的 人工 痕迹 也 比较 明显 如果 去过 类似 的 景点 个人 这里 没有 太 大 必要 再 来 夏天 自驾 乘凉 避暑 倒 是 个 不错 的 选择	__label__2
本来 就是 太湖 边上 一个 大 公园 而已 因为 出名 收 太贵 的 门票 不 值得 去 了 小时候 去 无锡 扫墓 完毕 都 会 去 几个 公园 转转 鼋头渚 、 蠡园 等 都 是 很 有 江南 味道 的 公园 门票 也 不是 很 贵 现在 太 湖水 很脏 很 臭 鼋头渚 收 这么 贵 的 门票 根本 不 值得 去 太湖 大道 边上 走走 就 可以 了 而且 鼋头渚 比起 杭州 西湖 也 是 差远了	__label__2
和 十年 前 一样 不 一样 的 是 椅子 坐 一会 一百 在 那个 浮在 水上 的 泡沫 搭 起来 的 排子 上 站 一下 就要 被 赶下去 炎亭 呵呵 想 钱 真的 想 疯 了 十年 之后 会 不会 就 倒闭 呢 很 想 知道	__label__1
风景 挺 漂亮 的 但是 人 不是 一般 的 多 不 推荐 去	__label__2
走马观花 游览 了 一下 大概 只用 一分钟 左右	__label__2
去 时 在 下雨 都 关门 了 也 不 知道 平时 热闹 吗 二个 城门 相距 不远 都 是 商户 好不好 还 需要 再 考察	__label__2
根本 算不上 景点 走进 去 就 一小 圈 像 个 小型 的 动物园 根本 不 值得 去 参观 @	__label__2
洞头 这边 景色 是 还好 的 但是 垃圾 污染 真的 是 很 严重 在 温州 玩 最 不好 的 体验 就是 其实 当地人 是 有点 排外 的 在 洞头 玩 海边 的 大排档 不 建议 去 很 坑 不 好吃 很 不 适应 当地 的 民宿 我 也 就 呵呵 了 民宿 老板 也 是 说 翻脸 就 翻脸 前 一秒 还是 笑呵呵 哒 后 一秒 恨不得 让 你 立即 打包 行李 走开 不多 说 想 去 的 人 自己 体验	__label__2
巷子 太窄 了 人太多 东西 太贵 咯	__label__2
平淡 而 遥远 虽 有 文化 内涵 却 无亮点 步入 古城 交通 困乱 店面 杂乱无章 毫无 特色 价格 却 不菲 来到 城内 几乎 没有 太 多 参观 的 欲望 晋商 成功 的 根源 在于 诚信 但 在 如今 的 古城 中 看见 的 更 多 是 山西 本地人 的 贪婪 的 眼神 和 无尽 的 欲望 我 不得不 说 我 是 逃离 平遥 的	__label__2
十大 坑景 之一 啥 也 没有 大家 就 别去了	__label__1
不是 我 想象 中 那么 的 好 很 无聊 的 地方	__label__1
太坑 了 月 日 竟然 不 开放 白排 了 两个 小时 队 没 进去 景区 停车场 还 收费 光出 停车场 就 用 了 半个 多 小时 一上午 行程 就 毁 了 无良 商家 强烈 鄙视 [ 鄙视 ]	__label__1
观看 个 升降 旗内 有 纪念塔 可以 看 下 现在 进入 广场 都 需要 安检 也 无法 在 广场 上 做 什么 活动 到此一游 罢了	__label__2
现在 的 西塘 太 商业化 了 少 了 份 悠然 已经 不 值得 去 了	__label__2
从 成都 开车 个 多 小时 到 了 车 不让 开 上山 只能 停 在 停车场 这太 不 方便 了 景区 内 的 酒店 住宿 的 做 他们 的 车 就 可以 进 然后 在 网上 找 了 一个 叫 飘香 山庄 住 的 其他 都 不 说 承诺 的 自己 没有 做到 还 多 有理 的 没有 多 消费 就是 没有 消费 能力 吗 贬低 别人 提高 自己 素质 真不知道 是 谁 低 出去玩 还	__label__2
风景区 外面 的 的 特产 市场 千万别 买 太 坑人 买 的 东西 容易 被 调包 好 的 容易 给 你 换成 很差 的 太湖 源 风景 还是 很 不错 但是 感觉 票 太贵 [ 生气 ] [ 生气 ] [ 生气 ] [ 生气 ]	__label__1
这个 景点 我 只能 给 一分 全国 类似 的 景点 实在 是 太 多 了 懒得 多 了 连 套路 都 熟悉 了 还 有些 店面 我们 真是 老朋友 啊 这么 多年 走过 这么 多 地方 每年 都 能 在 几个 景区 里 看到 你 的 影子 景区 的 同质化 真的 是 硬伤 看得 我 尴尬 症 都 犯 了 短短的 一条街 到处 是 天津 大 麻花 泥人张 果仁 张 神马 的 店 我们 都 知道 天津 的 特色 在 哪 可是 你 这样 搞 游客 会 觉得 大概 都 是 圈钱 的 天津 的 第一个 景点 不 喜欢 [ 咒骂 ] [ 心碎 了 ]	__label__1
慕名 去 看 音乐 喷泉 又 热 又 累 又 挤 千呼万唤 始 出来 真是 肠子 能悔 青 了 建议 大家 到 大雁塔 时间 对 上 了 可以 顺便 看看 根本 没有 说 的 那么 好看 喷泉 很 一般 很 一般 看着 照片 那么 好 根本 两码事	__label__2
人多 排队 排队 排队	__label__2
 真心 没来 过 这么 差 的 景点 草地 质量 很差 森林 灰不溜秋 的 无非 就是 些 骑马 的 自费 项目 到处 臭哄哄 的 烧烤 卫生条件 也 非常 差 就 这 竟然 还 连 很多 都 不如 一些 免费 的 森林公园 都 比 这 有意思 十一 从 重庆市 区花 了 六个 小时 过来 看 这破 玩意 真心 吐槽 无力 了 还 不如 在家 睡觉	__label__1
就是 爬山 没什么 风景 最 不爽 的 是 下山 大巴 售票员 找 零时 给 两张 残币 转身 就 耍赖 不认 态度恶劣 应该 是 故意 的 超级 影响 心情	__label__1
一点 都 不好玩 就 这么 一 丢 丢 的 地方 还排 老长 的 队 鞋套 都 是 湿 湿乎乎 的	__label__2
失望 ? ? ? ? ? ? ? ? ? ? ? ?	__label__2
点评 有奖 第季 总的来说 黄山 风景区 的 管理水平 极差 网络 订票 后 居然 还要 继续 排队 等候 换 实体 票 游客 拥堵 的 地段 居然 管理人员 视而不见 无人 疏导 任由 游客 无序 、 无德 、 无品 恶劣 拥挤 攀爬 也 出现 很 安全隐患 没有 出 群体 践踏 及 掉 崖 事故 是 该 景区 走运	__label__1
年轻人 的 集散地 好玩 很酷 现代	__label__1
不 值得 去 的 地方 里面 到处 是 吃 的 和 酒店 没什么 值得 去 的 太 亏了 这种 地方 去 一次 再也 不想 去 第二次 后悔 门票 还 那么 贵	__label__1
东栅 的 景点 还 真 没 啥 人 也 多 真 不 建议 去 而且 还 特小 没 怎么 逛 就 出来 了 太 没意思	__label__2
地址 · 北京 时尚 设计 广场 地址 北京市 朝阳区 酒仙桥 路 号	__label__1
其实 没什么 好 评论 的	__label__2
青龙湖 是 楠溪江 绿道 的 一个 休息 点 位于 深固 村 开车 过去 倒 是 很 方便 水色 不错 但 我们 到 这里 的 时候 正是 夏日 下午 点多 骄阳似火 所以 看 了 一眼 就 走 了 也许 傍晚 时来 游个泳 是 蛮 好 的	__label__2
坑爹 到 不行 全部 刷 出来 的 好评	__label__1
服务 比较 全面 隶属于 灵山 景区 非常 棒 的 景点 值得 一去 一般般	__label__2
服务态度 不好 索道 有点 贵再 便宜 点好 了	__label__2
期望 而 去 失望 而 归	__label__2
扩建 景点 很多 石窟 本身 不多 不 太 推荐	__label__2
首先 这是 一个 门票 不 分 淡旺季 的 景点 月 日 还是 元 的 门票 其次 景点 真的 很 一般 就是 看 月牙泉 虽然 在 沙漠 里 有湾 清泉 甚 是 难得 但是 代价 真高 不过 西北 的 景点 价格 真的 都 非常 贵 再次 服务态度 很差 整个 景区 的 工作人员 都 很 冷漠 还是 挺 让 人 失望 的 看 照片 比 实际 去 看 更 能 保留 美感	__label__2
总体 还行 吧	__label__2
我们 今天 一行 七个 人 下午 五点 半到 那里 都 没有 售票 的 人 买 门票 绝对 不会 去 直接 车子 开进去 在 古街 下来 逛 了 一圈 没什么 逛头 本来 就 打算 晚点 去 可以 免收 门票 反正 要 买 门票 就 绝对 不会 去 完全 不值	__label__1
一般 吧 性价比 不高 大部分 项目 排队 的 人 都 很多 玩 不了 几个 项目	__label__2
一次 就 好	__label__2
挂羊头卖狗肉 根本 不是 生态 旅游区	__label__1
性价比 太低 吃饭 很 不 方便	__label__2
谭嗣同 是 戊戌变法 牺牲 的 六 君子 之一 他 主张 变法维新 清光绪 二十四年 年 变法 失败 被 杀 年 仅 岁 在 北京 活动 期间 他 住 在 北 半截 胡同 的 湖南 浏阳 会馆 浏阳 会馆 的 五间 正房 仍 保存 完好 背面 两间 是 谭嗣同 当年 居住 的 地方	__label__2
大 竹海	__label__2
五大连池市 五 大连市 风景区 极差 评 今天 打 出租车 去 五大连池 老黑山 景区 结果 出租车 司机 把 我 送 了 堰塞湖 景区 收 了 车费 后来 发现 不 对 明明 要 去 山 的 怎么 是 湖 、 司机 不仅 不 承认 送错 了 地方 说 什么 到 老黑山 只能 水路 不能 陆路 除非 他 车子 能 游水 才能 到 老黑山 景区 还 找 了 一个 其它 的 司机 装做 景点 的 工作人员 给 他 做 证明 但是 任何 景点 的 旅游 图 都 有 啊 明明 可以 陆路 去 老黑山 的 最后 就是 他 走 了 我 就 只能 回走 了 从 堰塞湖 回到 风景区 入口 有 公里 其中 我 在 路上 两个 景点 处问 景点 工作人员 回去 的 大巴 哪里 坐 景点 的 售票员 说 问进 景点 口 的 工作人员 进 景点 口 的 工作人员 说 这个 要 问 停车场 停车场 的 工作人员 说 你 打车 吧 没有 大巴 打车 我 就 呵呵 了	__label__1
非常 不怎么样	__label__2
儿童公园 附近 的 吉林 老省 博物馆 渣 到 不行 除了 党务工作 成就 展览 就 没 展品 了 话 说 新 省博 还要 等到 什么 时候 开 啊	__label__1
独自 游	__label__2
门票 元 不 值得 一去 当然 仁者见仁 智者见智	__label__1
对比 颐和园 来说 圆明园 真心 不是 太 有意思	__label__2
不 推荐 去 比较 远 不 说 不好玩	__label__2
公司 组织 出游 整体 感觉不好 在于 季节 也 不 对 整条 山涧 没有 水 没有 水 的 山 还是 在 千岛湖 根本就是 坑人 的 行程 一路 没有 什么 值得 说 的 三处 收费 的 项目 都 是 坑人 的 尽管 少 有人 上当 还是 很 煞风景 的 尽管 也 没有 风景 杭州 所有 的 地方 都 比 这里 强	__label__1
龙潭 公园 位于 北京市 东城区 原 北京市 崇文区 龙潭 北 里 小区 对面 目前 是 国家级 旅游 公园 龙潭 公园 占地 公顷 是 大部分 南城 居民 休闲 、 娱乐 、 健身 的 主要 场所 同时 每年 农历 春节 的 庙会 也 是 北京 四大 庙会 之一	__label__1
石花洞 给 我 的 印象 特别 一般 特别 是 还 没到 就 有 一群 大妈 大叔 拦着 路收 停车费 而且 态度 特别 差 不 解释 清楚 停车 收费 情况 就 只要 钱 一群 刁民 这 景区 管理 不 完善 建议 别去 洞里 比较 潮湿 个人感觉 看不懂 别去了	__label__2
体验 感 真心 差	__label__2
今天 去 的 明天 就 不 记得 了	__label__1
不好玩 千万别 去 没什么 景色 看去 的 时候 黄山 刚好 对 东北 地方 免票 人 特多 门票 太贵 了 很 失望	__label__2
最 没有 古城 味 的 四大 古城 之一 虽然 我 只 去过 两个 四大 古城 徽州 古城 是 最差 的 一个 就 一条 商业街 还要 门票 才能 进 还好 我 没 买 门票 没背 背包 就 不用 买 如果 想 看 古城 的 绝对 不 推荐 徽州 古城	__label__1
没 啥意思 的 地方	__label__1
不 推荐 我 之前 网上 看到 还行 到 了 目的地 之后 只能 呵呵	__label__2
真是 忽悠 的 地方 根本 和 以前 不 一样	__label__2
性价比 很 低 的 一次 出游	__label__2
现在 都 改成 公司 和 会 所 什么 的 了 没 啥意思	__label__2
宁波 鼓楼 至今已有 多年 的 历史 是 宁波市 唯一 仅存 的 古 城楼 遗址 是 国家 文物 重点保护 的 古建筑 之一 周边 是 步行街 可以 买 一些 小玩意儿	__label__2
山上 晚上 有没有 人 自带 帐篷 去 睡 的 呢	__label__2
比 想象 中 的 差太多	__label__2
有 竹林 有 湖面 还有 瀑布 景区 还是 比较 大 的 自然风光 可以 但是 实在 是 没有 怎么 开发 感觉 乱糟糟 的 台阶 设置 特别 不合理 高度 不 一 路面 不 平整 不要 说 老年人 玩 了 就是 年轻人 爬 着 都 很 费劲 就 这样 还要 元 一人 不 推荐 游玩	__label__2
从 县城 到 江岭 、 篁 岭 必经 的 中转站 本身 也 有 景区 但 据说 就 那么回事 为什么 能 评上 大家 心知肚明	__label__2
说实话 景观 还 不错 但 就是 停车 乱收费 村民 拦下 说 去 家里 吃 农家菜 就 可以 不用 停车费 不然 就 得 在 停车场 交完 停车费 走上 去 不然 做 摆渡 车 来回 每人 元 四个 人 就 了 抱 着 的 小孩子 也 算 真够 坑人 的 那里 吃饭 还 算 凑合 吧 景观 还是 不错 就是 洞里 超市 带 小孩子 的 朋友 不 建议 去 洞里常 年度 左右 可 进去 后 爬楼梯 爬 的 就 开始 出汗 不 建议 多 穿衣服 进去	__label__2
我能 说 这 真 尼玛 是 我 见 过 最 垃圾 的 乐园 了 吗 我够 优惠条件 买 半价票 但是 里面 还有 四个 项目 要 单独 收费 除了 收费 的 项目 以外 其他 的 都 是 什么 垃圾 玩意儿 啊 那个 冒险 王国 里面 放 的 电影 真是 白 瞎 了 那块 大 荧幕 了 还有 什么 火山 喷发 把 一堆 人关 到 黑 屋子 里面 看着 一滩 水 冒泡 站 在 充满 汗臭味 的 人 挤 人 的 屋子里 听 着 背景音乐 讲 一个 十分钟 的 鬼故事 还有 银河 宫 更是 傻 缺到 了 极点 一群 人 围着 圈 听 回音 玩 真是 垃圾 透顶 不 知道 怎么 评 上级 景区 的 坐 我 旁边 的 孩子 都 说 还 不如 在家 看电视	__label__1
去 了 我 是 很 失望 的 · · · 的 · · ·	__label__2
风景 很 好 过于 单一 需 丰富	__label__2
不错 很 不错 总之 很 划算 我 觉得 特别 棒	__label__2
这个 地方 去 的 时候 很多 雾 真 看不清 什么 东西 被 人 忽悠 过去 坐 索道 元来 回去 看 那个 大 口 瀑布 实话实说 元 索道 性价比 很 高 一程 得 分钟 就是 有雾 啥 都 看不到 但是 过去 了 进入 景区 还 需要 元 而且 看 的 也 就是 涓涓细流 假如 去 了 三叠 泉 就 不用 去 这里 了 没 啥意思 直接 上 图	__label__2
说实话 对 西湖 是 保有 很大 希望 的 正 所谓 希望 越大 失望 越大 就 感觉 是 个 湖边 公园 国庆 期间 各种 性价比 超高 的 产品开发 块钱 的 游船 不许 营业 只能 开一 小时 的 游船 人山人海 环湖 小店 一个 店 比 一个 店 价格 高 走 到 白堤 实在 走不动 了 决定 去 做 公交 游好 嘛 两块钱 的 公	__label__2
景区 没有 趣味性 表演 的 演员 一副 死人 脸上 台 还 在 议论 什么	__label__1
桥上 有 聋哑人 拉着 拍照 拍 完后 给 你 说 要 块钱 没人管 的 么	__label__1
妈蛋 我 不想 骂人 但是 在 忍 不了 呵呵 我 大帝 都 进 了 骗子 窝 了	__label__1
太贵 了 很 不值 特别 是 缆车 一百 一人 小孩 还 没 优惠	__label__1
人太多 一路 堵 过去 到 了 门口 没 地方 停车 最终 没去 成 直接 回去 了	__label__1
毫无 趣味	__label__2
感觉 有点 坑人 的 门票 连 大巴 都 不 包括 另外 还 得 坐 索道 和 缆车 比 门票 还贵 呢 沿途 除了 山 还是 山 也 没什么 好看 的 景点 就是 山 比较 壮观 点 山上 指示牌 也 不 明显 容易 走 错路 工作人员 也 很少 真是 应 了 看景 不如 听景 这句 话	__label__2
